player_id,player_name,opponent_id,opponent_name,played,wins_left,wins_right
748064029,Paul Hughes,60575249,Ash Thurmer,23,18,5
802242736,Steve Hughes,96354463,Rob Pickard,20,15,5
802242736,Steve Hughes,278731588,Lester Grice,19,15,4
278731588,Lester Grice,341869673,Nigel Stilwell,17,16,1
428102632,Anthony Flynn,802242736,Steve Hughes,17,13,4
748064029,Paul Hughes,96354463,Rob Pickard,16,15,1
752709358,Chris Mason,523395206,Jamie Lashmar,15,8,7
341869673,Nigel Stilwell,957784480,Harry Banks,14,14,0
646410961,Paul Scorer,748064029,Paul Hughes,13,10,3
845758589,Charlie James,392533233,Jack Wright,13,7,6
59858690,James Constable,428102632,Anthony Flynn,12,8,4
59858690,James Constable,802242736,Steve Hughes,12,8,4
278731588,Lester Grice,428102632,Anthony Flynn,12,7,5
752709358,Chris Mason,670256222,Connor Anderson,12,8,4
858283721,Dave Dunstall,180,Pat Sweeney,12,9,3
11133032,Simon Dent,96103077,Paul Norris,11,7,4
523395206,Jamie Lashmar,11133032,Simon Dent,11,7,4
809568302,Mark Johnson,428102632,Anthony Flynn,11,9,2
809568302,Mark Johnson,748064029,Paul Hughes,11,9,2
948504778,Jon Fordham,748064029,Paul Hughes,11,7,4
957784480,Harry Banks,646410961,Paul Scorer,11,6,5
231445676,Tony Paice,529382351,Greg Foat,10,7,3
617751649,Lee Simpson,341869673,Nigel Stilwell,10,8,2
617751649,Lee Simpson,523395206,Jamie Lashmar,10,6,4
649240057,Mike Childs,426236650,Dave Parrott,10,7,3
670256222,Connor Anderson,278731588,Lester Grice,10,9,1
670256222,Connor Anderson,957784480,Harry Banks,10,8,2
752709358,Chris Mason,278731588,Lester Grice,10,9,1
754250007,Freddie Blunden,802242736,Steve Hughes,10,9,1
34787509,Dave McCarthy,802242736,Steve Hughes,9,7,2
59858690,James Constable,278731588,Lester Grice,9,7,2
96103077,Paul Norris,323907964,Russ Hughes,9,6,3
266591683,Chris Roche,529382351,Greg Foat,9,9,0
384960657,Dave Lewney,957784480,Harry Banks,9,7,2
428102632,Anthony Flynn,748064029,Paul Hughes,9,5,4
617751649,Lee Simpson,428102632,Anthony Flynn,9,5,4
617751649,Lee Simpson,957784480,Harry Banks,9,7,2
752709358,Chris Mason,96103077,Paul Norris,9,5,4
752709358,Chris Mason,646410961,Paul Scorer,9,6,3
809568302,Mark Johnson,802242736,Steve Hughes,9,6,3
809568302,Mark Johnson,963958265,Rodney Moogan,9,7,2
820231590,Alan Rook,845758589,Charlie James,9,6,3
11133032,Simon Dent,323907964,Russ Hughes,8,4,4
11133032,Simon Dent,617751649,Lee Simpson,8,6,2
11133032,Simon Dent,752709358,Chris Mason,8,4,4
16253983,Tony Simmonds,180,Pat Sweeney,8,6,2
96103077,Paul Norris,617751649,Lee Simpson,8,4,4
96103077,Paul Norris,794630189,Mark Coles,8,5,3
112887737,Pip Akehurst,428102632,Anthony Flynn,8,4,4
114184042,Ian Smith,661923191,Steve Gardner,8,4,4
229719541,Scott Manning,394906196,Mick Mabbitt,8,7,1
278731588,Lester Grice,506581042,Glen Dartnell,8,5,3
345558874,Zack Richardson,323907964,Russ Hughes,8,6,2
426009127,Bav Patel,133207947,Jake Richardson,8,5,3
426009127,Bav Patel,754250007,Freddie Blunden,8,5,3
523395206,Jamie Lashmar,646410961,Paul Scorer,8,6,2
646410961,Paul Scorer,59858690,James Constable,8,7,1
646410961,Paul Scorer,426009127,Bav Patel,8,7,1
752709358,Chris Mason,60575249,Ash Thurmer,8,7,1
752709358,Chris Mason,96354463,Rob Pickard,8,8,0
752709358,Chris Mason,515186402,Ben Evans,8,5,3
752709358,Chris Mason,748064029,Paul Hughes,8,7,1
754250007,Freddie Blunden,957784480,Harry Banks,8,6,2
766684900,John Gillard,617751649,Lee Simpson,8,5,3
809568302,Mark Johnson,506581042,Glen Dartnell,8,6,2
936624299,Peter Gallant,394906196,Mick Mabbitt,8,7,1
948504778,Jon Fordham,963958265,Rodney Moogan,8,5,3
65,Paul Hudson,836895047,Ian McKay,7,6,1
180,Pat Sweeney,963206772,Dean Moore,7,6,1
16253983,Tony Simmonds,124523642,Tom Hayes,7,5,2
96103077,Paul Norris,809568302,Mark Johnson,7,7,0
133207947,Jake Richardson,278731588,Lester Grice,7,5,2
174147986,Lee Cliff,411473516,Ray Canham,7,4,3
225850882,John McLellan,836895047,Ian McKay,7,4,3
229719541,Scott Manning,613893140,Matt Warner,7,7,0
278731588,Lester Grice,426009127,Bav Patel,7,4,3
323907964,Russ Hughes,96354463,Rob Pickard,7,4,3
345558874,Zack Richardson,523395206,Jamie Lashmar,7,4,3
384960657,Dave Lewney,428102632,Anthony Flynn,7,4,3
384960657,Dave Lewney,802242736,Steve Hughes,7,4,3
428102632,Anthony Flynn,34787509,Dave McCarthy,7,7,0
428102632,Anthony Flynn,948504778,Jon Fordham,7,5,2
484159049,Tommy Wright,732415457,Barry Hall,7,5,2
523395206,Jamie Lashmar,96354463,Rob Pickard,7,6,1
523395206,Jamie Lashmar,133207947,Jake Richardson,7,4,3
523395206,Jamie Lashmar,670256222,Connor Anderson,7,5,2
523395206,Jamie Lashmar,963958265,Rodney Moogan,7,7,0
574248035,Tony Mulhern,114184042,Ian Smith,7,4,3
617751649,Lee Simpson,278731588,Lester Grice,7,5,2
617751649,Lee Simpson,426009127,Bav Patel,7,4,3
617751649,Lee Simpson,506581042,Glen Dartnell,7,5,2
617751649,Lee Simpson,748064029,Paul Hughes,7,4,3
617751649,Lee Simpson,794630189,Mark Coles,7,6,1
646410961,Paul Scorer,133207947,Jake Richardson,7,5,2
646410961,Paul Scorer,323907964,Russ Hughes,7,4,3
800114325,Roger Whiteley,41098823,Mikey Booker,7,5,2
802242736,Steve Hughes,963958265,Rodney Moogan,7,4,3
809568302,Mark Johnson,96354463,Rob Pickard,7,4,3
809568302,Mark Johnson,278731588,Lester Grice,7,4,3
825399596,Pat Adams,809568302,Mark Johnson,7,5,2
858283721,Dave Dunstall,963206772,Dean Moore,7,4,3
889234854,Paul Smith,444350794,Richard Freeman,7,4,3
954080507,Sam Corsby,124,Dave Tristram,7,6,1
970786910,Kevin Sorrell,833156731,Jez Saunders,7,7,0
974385564,Danny Booker,809647573,John Taylor,7,6,1
61,Paul Gander,279543944,Peter Maurice,6,3,3
65,Paul Hudson,202090738,Alan Head,6,5,1
80,Dave Wells,649240057,Mike Childs,6,4,2
179,Mick Jones,149,Tony Nealgrove,6,5,1
179,Mick Jones,732415457,Barry Hall,6,3,3
180,Pat Sweeney,278,Dave Fairbairn,6,4,2
183,Simon Alexander,480154054,Jim Dunstall,6,5,1
440,Gordon Carter,845758589,Charlie James,6,4,2
11133032,Simon Dent,809568302,Mark Johnson,6,4,2
32061370,Toby Prince-Iles,294944526,Rob Teanby,6,3,3
34787509,Dave McCarthy,426009127,Bav Patel,6,5,1
34787509,Dave McCarthy,752709358,Chris Mason,6,4,2
39289507,Mick Laughlin,674307680,Neil McCafferty,6,5,1
41461520,Luke Pooley,649240057,Mike Childs,6,3,3
59858690,James Constable,748064029,Paul Hughes,6,3,3
59858690,James Constable,809568302,Mark Johnson,6,3,3
70159035,Peter Rea,831214643,Tony Shipley,6,5,1
96103077,Paul Norris,96354463,Rob Pickard,6,6,0
96103077,Paul Norris,426009127,Bav Patel,6,5,1
96103077,Paul Norris,963958265,Rodney Moogan,6,6,0
96354463,Rob Pickard,948504778,Jon Fordham,6,5,1
96354463,Rob Pickard,963958265,Rodney Moogan,6,4,2
112887737,Pip Akehurst,225850882,John McLellan,6,6,0
112887737,Pip Akehurst,719124015,Tony Power,6,5,1
133207947,Jake Richardson,748064029,Paul Hughes,6,4,2
133207947,Jake Richardson,957784480,Harry Banks,6,4,2
229719541,Scott Manning,279543944,Peter Maurice,6,6,0
229719541,Scott Manning,688252012,Sean Cooper,6,5,1
229719541,Scott Manning,820231590,Alan Rook,6,6,0
258340682,John Derret,41098823,Mikey Booker,6,4,2
275738778,John Da Silva,899206834,Jez Downs,6,4,2
278731588,Lester Grice,948504778,Jon Fordham,6,4,2
307140835,Tony Strange,802242736,Steve Hughes,6,5,1
345558874,Zack Richardson,96103077,Paul Norris,6,5,1
384960657,Dave Lewney,948504778,Jon Fordham,6,5,1
384960657,Dave Lewney,963958265,Rodney Moogan,6,6,0
386517733,Ady Halley,567624732,Dave Brampton,6,3,3
394906196,Mick Mabbitt,612265840,Paul Honeysett,6,4,2
428102632,Anthony Flynn,60575249,Ash Thurmer,6,4,2
428102632,Anthony Flynn,426009127,Bav Patel,6,5,1
428102632,Anthony Flynn,865803068,Dave Jones,6,3,3
430890681,Malcolm Cooper,394906196,Mick Mabbitt,6,5,1
463709832,Danny Wong,688778183,Dean Paice,6,3,3
490170224,Jamie Matthews,436708540,Bob Henley,6,6,0
515186402,Ben Evans,428102632,Anthony Flynn,6,5,1
523395206,Jamie Lashmar,662568995,Rob Wykes,6,5,1
523395206,Jamie Lashmar,809568302,Mark Johnson,6,5,1
535728699,Fred Cooper,688252012,Sean Cooper,6,5,1
567316488,Lee Millyard,231445676,Tony Paice,6,4,2
567624732,Dave Brampton,41461520,Luke Pooley,6,6,0
574248035,Tony Mulhern,412256116,Andy Sutton,6,5,1
613893140,Matt Warner,32061370,Toby Prince-Iles,6,4,2
619390728,Steve Stylianou,748064029,Paul Hughes,6,4,2
646410961,Paul Scorer,96354463,Rob Pickard,6,4,2
646410961,Paul Scorer,278731588,Lester Grice,6,5,1
670256222,Connor Anderson,133207947,Jake Richardson,6,4,2
670256222,Connor Anderson,748064029,Paul Hughes,6,5,1
670256222,Connor Anderson,766684900,John Gillard,6,4,2
670256222,Connor Anderson,825399596,Pat Adams,6,4,2
670256222,Connor Anderson,963958265,Rodney Moogan,6,5,1
688778183,Dean Paice,831214643,Tony Shipley,6,3,3
704007508,Alan Muir,537640521,Ian Stoner,6,4,2
721321839,Matt Peake,949603489,Pete Bennett,6,3,3
732415457,Barry Hall,124523642,Tom Hayes,6,4,2
752709358,Chris Mason,794630189,Mark Coles,6,3,3
754250007,Freddie Blunden,428102632,Anthony Flynn,6,4,2
754250007,Freddie Blunden,963958265,Rodney Moogan,6,6,0
766684900,John Gillard,802242736,Steve Hughes,6,6,0
800114325,Roger Whiteley,484159049,Tommy Wright,6,4,2
800114325,Roger Whiteley,490170224,Jamie Matthews,6,4,2
809568302,Mark Johnson,619390728,Steve Stylianou,6,4,2
809647573,John Taylor,889234854,Paul Smith,6,3,3
809984729,Neil Scutt,929636592,Danny Wilson,6,4,2
820231590,Alan Rook,815023707,David Senior,6,4,2
836895047,Ian McKay,717256135,Trevor Pickard,6,5,1
936624299,Peter Gallant,612265840,Paul Honeysett,6,4,2
943667183,John Stone,745152759,Kevin Jewell,6,6,0
966905561,Tony Dade,978156264,Bob Paine,6,4,2
970786910,Kevin Sorrell,733453947,Phil Canham,6,5,1
14,Michael West,323907964,Russ Hughes,5,3,2
61,Paul Gander,800114325,Roger Whiteley,5,3,2
98,Tony Collins,845758589,Charlie James,5,4,1
124,Dave Tristram,173,Dave Alderton,5,3,2
247,Mick Justice,316,Paul Redgate,5,4,1
309,M. Humphries,275738778,John Da Silva,5,4,1
395,Herby Burchell,65,Paul Hudson,5,3,2
11133032,Simon Dent,646410961,Paul Scorer,5,4,1
11133032,Simon Dent,670256222,Connor Anderson,5,3,2
11133032,Simon Dent,754250007,Freddie Blunden,5,4,1
11133032,Simon Dent,957784480,Harry Banks,5,5,0
16253983,Tony Simmonds,326342962,Geoff Randall,5,4,1
16253983,Tony Simmonds,670034050,John Muzio,5,5,0
16253983,Tony Simmonds,732415457,Barry Hall,5,5,0
16253983,Tony Simmonds,858283721,Dave Dunstall,5,4,1
16253983,Tony Simmonds,974385564,Danny Booker,5,3,2
34787509,Dave McCarthy,278731588,Lester Grice,5,3,2
34787509,Dave McCarthy,754250007,Freddie Blunden,5,3,2
39289507,Mick Laughlin,101751030,Simon Uddin,5,3,2
60575249,Ash Thurmer,90176364,David Page,5,3,2
60575249,Ash Thurmer,802242736,Steve Hughes,5,4,1
70159035,Peter Rea,223983583,Carl Wentworth,5,5,0
70159035,Peter Rea,567624732,Dave Brampton,5,4,1
96103077,Paul Norris,506581042,Glen Dartnell,5,4,1
96103077,Paul Norris,748064029,Paul Hughes,5,5,0
96103077,Paul Norris,754250007,Freddie Blunden,5,3,2
96103077,Paul Norris,957784480,Harry Banks,5,3,2
96354463,Rob Pickard,26970170,Kai Michael,5,4,1
96354463,Rob Pickard,133207947,Jake Richardson,5,4,1
96354463,Rob Pickard,428102632,Anthony Flynn,5,4,1
96354463,Rob Pickard,506581042,Glen Dartnell,5,3,2
112887737,Pip Akehurst,954080507,Sam Corsby,5,3,2
120138229,Adam Butler,889234854,Paul Smith,5,4,1
120138229,Adam Butler,949603489,Pete Bennett,5,5,0
124523642,Tom Hayes,114184042,Ian Smith,5,4,1
133207947,Jake Richardson,428102632,Anthony Flynn,5,4,1
144293731,Simon Parry,954297832,Pav Sareen,5,3,2
160950731,Locky McCurdy,612265840,Paul Honeysett,5,5,0
171346729,Des Heasman,121,Mike Barnett,5,4,1
171346729,Des Heasman,386517733,Ady Halley,5,3,2
171346729,Des Heasman,394906196,Mick Mabbitt,5,5,0
171346729,Des Heasman,901024459,Paul Charman,5,3,2
174147986,Lee Cliff,360777082,Mark Bishop,5,4,1
174147986,Lee Cliff,444350794,Richard Freeman,5,5,0
174147986,Lee Cliff,845758589,Charlie James,5,4,1
225850882,John McLellan,412256116,Andy Sutton,5,4,1
229719541,Scott Manning,490170224,Jamie Matthews,5,4,1
231975313,Danny English,76,David Rea,5,3,2
266591683,Chris Roche,719124015,Tony Power,5,5,0
271464632,Paul Phillips,76011459,Kane Harman,5,3,2
278731588,Lester Grice,26970170,Kai Michael,5,3,2
279543944,Peter Maurice,41461520,Luke Pooley,5,4,1
279543944,Peter Maurice,172646809,Robin Powell,5,3,2
279543944,Peter Maurice,820231590,Alan Rook,5,5,0
293577764,Dave Crosskey,943667183,John Stone,5,4,1
301960429,Brian Collins,936624299,Peter Gallant,5,4,1
306438070,Martin Stocker,436708540,Bob Henley,5,5,0
307140835,Tony Strange,11133032,Simon Dent,5,3,2
307140835,Tony Strange,34787509,Dave McCarthy,5,5,0
307140835,Tony Strange,748064029,Paul Hughes,5,4,1
319057545,Brendan Lambe,98,Tony Collins,5,3,2
323907964,Russ Hughes,617751649,Lee Simpson,5,3,2
326342962,Geoff Randall,41098823,Mikey Booker,5,3,2
327948141,Ross Etheridge,412256116,Andy Sutton,5,4,1
345558874,Zack Richardson,307140835,Tony Strange,5,3,2
345558874,Zack Richardson,766684900,John Gillard,5,4,1
345558874,Zack Richardson,957784480,Harry Banks,5,4,1
349269645,Barry Thornton,291816585,Jim Somers,5,3,2
349269645,Barry Thornton,936624299,Peter Gallant,5,4,1
351143642,Michael Palmer,386517733,Ady Halley,5,3,2
351143642,Michael Palmer,417786644,Eddie Collins,5,3,2
356397577,David Morgan,957784480,Harry Banks,5,4,1
360777082,Mark Bishop,349269645,Barry Thornton,5,3,2
384960657,Dave Lewney,600385553,Darren Welfare,5,4,1
384960657,Dave Lewney,797962517,Dave Lewis,5,4,1
386517733,Ady Halley,417786644,Eddie Collins,5,4,1
386517733,Ady Halley,480154054,Jim Dunstall,5,4,1
386517733,Ady Halley,495939788,Tyrone Davis,5,4,1
386517733,Ady Halley,529382351,Greg Foat,5,5,0
386517733,Ady Halley,713064363,John Trory,5,4,1
394906196,Mick Mabbitt,160950731,Locky McCurdy,5,3,2
411473516,Ray Canham,866506631,Mark Smith,5,3,2
423038309,Ian Fennell,954080507,Sam Corsby,5,4,1
426009127,Bav Patel,662568995,Rob Wykes,5,3,2
426009127,Bav Patel,954297832,Pav Sareen,5,3,2
428102632,Anthony Flynn,26970170,Kai Michael,5,3,2
428102632,Anthony Flynn,619390728,Steve Stylianou,5,4,1
428102632,Anthony Flynn,957784480,Harry Banks,5,3,2
436708540,Bob Henley,3508579,John Murray,5,4,1
436708540,Bob Henley,836895047,Ian McKay,5,3,2
444339215,Steve Richards,820231590,Alan Rook,5,4,1
455401154,Kai Ellis,574248035,Tony Mulhern,5,4,1
484159049,Tommy Wright,867613624,Ian Dunhill,5,4,1
490170224,Jamie Matthews,899206834,Jez Downs,5,4,1
493830161,Luke Strevens,867613624,Ian Dunhill,5,4,1
506320151,Frank Taylor,301,Terry Grant,5,4,1
506320151,Frank Taylor,436708540,Bob Henley,5,3,2
515186402,Ben Evans,617751649,Lee Simpson,5,3,2
515186402,Ben Evans,809568302,Mark Johnson,5,4,1
523395206,Jamie Lashmar,426009127,Bav Patel,5,4,1
523395206,Jamie Lashmar,428102632,Anthony Flynn,5,5,0
523395206,Jamie Lashmar,802242736,Steve Hughes,5,4,1
523395206,Jamie Lashmar,825399596,Pat Adams,5,3,2
523395206,Jamie Lashmar,957784480,Harry Banks,5,4,1
535728699,Fred Cooper,32061370,Toby Prince-Iles,5,3,2
535728699,Fred Cooper,845758589,Charlie James,5,3,2
556095121,Tom Wright,649240057,Mike Childs,5,3,2
567316488,Lee Millyard,278731588,Lester Grice,5,3,2
567624732,Dave Brampton,266477517,Tony Baxter,5,5,0
567624732,Dave Brampton,936624299,Peter Gallant,5,4,1
567624732,Dave Brampton,953512654,Les Berry,5,3,2
573567936,Steve Marriott,279543944,Peter Maurice,5,4,1
573567936,Steve Marriott,936624299,Peter Gallant,5,3,2
574248035,Tony Mulhern,124,Dave Tristram,5,3,2
574248035,Tony Mulhern,3508579,John Murray,5,4,1
608140548,David Gillingham,836895047,Ian McKay,5,4,1
613893140,Matt Warner,39289507,Mick Laughlin,5,5,0
646410961,Paul Scorer,341869673,Nigel Stilwell,5,4,1
646410961,Paul Scorer,506581042,Glen Dartnell,5,4,1
646410961,Paul Scorer,662568995,Rob Wykes,5,4,1
646410961,Paul Scorer,809568302,Mark Johnson,5,3,2
646410961,Paul Scorer,948504778,Jon Fordham,5,3,2
646410961,Paul Scorer,954297832,Pav Sareen,5,3,2
662568995,Rob Wykes,802242736,Steve Hughes,5,3,2
666735933,Mike Collier,59858690,James Constable,5,4,1
666735933,Mike Collier,96354463,Rob Pickard,5,4,1
666735933,Mike Collier,307140835,Tony Strange,5,3,2
666735933,Mike Collier,619390728,Steve Stylianou,5,4,1
666735933,Mike Collier,646410961,Paul Scorer,5,3,2
666735933,Mike Collier,802242736,Steve Hughes,5,4,1
669385277,Steve Towler,278,Dave Fairbairn,5,3,2
669385277,Steve Towler,480154054,Jim Dunstall,5,5,0
670034050,John Muzio,721321839,Matt Peake,5,4,1
670256222,Connor Anderson,426009127,Bav Patel,5,4,1
688778183,Dean Paice,65,Paul Hudson,5,5,0
688778183,Dean Paice,704007508,Alan Muir,5,4,1
717256135,Trevor Pickard,88,Steve Collins,5,5,0
717256135,Trevor Pickard,412256116,Andy Sutton,5,3,2
717256135,Trevor Pickard,670034050,John Muzio,5,4,1
724342701,Nigel Lilley,613893140,Matt Warner,5,3,2
724342701,Nigel Lilley,669385277,Steve Towler,5,4,1
746406369,Loz O'Keefe,98,Tony Collins,5,3,2
748064029,Paul Hughes,384960657,Dave Lewney,5,3,2
748064029,Paul Hughes,957784480,Harry Banks,5,4,1
748064029,Paul Hughes,963958265,Rodney Moogan,5,4,1
752709358,Chris Mason,59858690,James Constable,5,5,0
752709358,Chris Mason,809788967,Brett Williams,5,5,0
752709358,Chris Mason,957784480,Harry Banks,5,4,1
754250007,Freddie Blunden,133207947,Jake Richardson,5,4,1
754250007,Freddie Blunden,307140835,Tony Strange,5,4,1
754250007,Freddie Blunden,646410961,Paul Scorer,5,4,1
754250007,Freddie Blunden,670256222,Connor Anderson,5,3,2
754250007,Freddie Blunden,748064029,Paul Hughes,5,3,2
766684900,John Gillard,307140835,Tony Strange,5,4,1
766684900,John Gillard,963958265,Rodney Moogan,5,5,0
797962517,Dave Lewis,60575249,Ash Thurmer,5,3,2
797962517,Dave Lewis,133207947,Jake Richardson,5,3,2
800114325,Roger Whiteley,16253983,Tony Simmonds,5,3,2
802242736,Steve Hughes,732321233,Nathan Brooks,5,3,2
802242736,Steve Hughes,850059806,Heng Wong,5,4,1
809568302,Mark Johnson,26970170,Kai Michael,5,3,2
809568302,Mark Johnson,948504778,Jon Fordham,5,4,1
820231590,Alan Rook,293577764,Dave Crosskey,5,4,1
820231590,Alan Rook,649240057,Mike Childs,5,3,2
825399596,Pat Adams,662568995,Rob Wykes,5,3,2
831214643,Tony Shipley,392533233,Jack Wright,5,4,1
831214643,Tony Shipley,936624299,Peter Gallant,5,4,1
836895047,Ian McKay,831214643,Tony Shipley,5,3,2
845758589,Charlie James,279543944,Peter Maurice,5,3,2
845758589,Charlie James,833156731,Jez Saunders,5,3,2
848997254,Tom Parker,225850882,John McLellan,5,4,1
856755662,David Marsh,171346729,Des Heasman,5,5,0
867613624,Ian Dunhill,394906196,Mick Mabbitt,5,5,0
873916947,Geoff Akehurst,293577764,Dave Crosskey,5,3,2
873916947,Geoff Akehurst,436708540,Bob Henley,5,3,2
876526526,Ash Bull,384960657,Dave Lewney,5,3,2
922772801,Nick Buonanno,360777082,Mark Bishop,5,4,1
943667183,John Stone,223983583,Carl Wentworth,5,3,2
943667183,John Stone,291816585,Jim Somers,5,5,0
943667183,John Stone,351143642,Michael Palmer,5,4,1
948504778,Jon Fordham,26970170,Kai Michael,5,4,1
949603489,Pete Bennett,670034050,John Muzio,5,5,0
953512654,Les Berry,223983583,Carl Wentworth,5,4,1
954080507,Sam Corsby,974385564,Danny Booker,5,3,2
954297832,Pav Sareen,463709832,Danny Wong,5,4,1
957784480,Harry Banks,34787509,Dave McCarthy,5,4,1
963206772,Dean Moore,866506631,Mark Smith,5,3,2
963958265,Rodney Moogan,60575249,Ash Thurmer,5,4,1
963958265,Rodney Moogan,957784480,Harry Banks,5,3,2
966905561,Tony Dade,284,Ray Bradley,5,4,1
970786910,Kevin Sorrell,179,Mick Jones,5,4,1
970786910,Kevin Sorrell,858283721,Dave Dunstall,5,3,2
971308746,Clive Harman,32061370,Toby Prince-Iles,5,4,1
974385564,Danny Booker,800114325,Roger Whiteley,5,4,1
3,Neal Gozzett,223,Ollie Stalley,4,2,2
6,Dan Stirling,365,Dan Buckwell,4,3,1
16,Mick Beck,503528426,Larry Maloney,4,4,0
65,Paul Hudson,114184042,Ian Smith,4,2,2
84,Gavin McCubbin,448,Adam Bradshaw,4,2,2
89,Mike Atkins,278731588,Lester Grice,4,4,0
96,Dave Kellett,844676925,Kieran Williams,4,2,2
97,Shaun Winsor,844676925,Kieran Williams,4,2,2
121,Mike Barnett,319,John Lojo,4,3,1
124,Dave Tristram,901024459,Paul Charman,4,4,0
149,Tony Nealgrove,480154054,Jim Dunstall,4,2,2
174,Brian Grant,121,Mike Barnett,4,4,0
177,John Regan,124,Dave Tristram,4,3,1
179,Mick Jones,76,David Rea,4,3,1
179,Mick Jones,199,Mark Holloway,4,3,1
180,Pat Sweeney,174147986,Lee Cliff,4,3,1
180,Pat Sweeney,669385277,Steve Towler,4,4,0
181,Dave Roughley,307,Alister Morrison,4,2,2
181,Dave Roughley,386517733,Ady Halley,4,3,1
182,Brian Welfare,202,Bob Firth,4,2,2
182,Brian Welfare,866506631,Mark Smith,4,2,2
183,Simon Alexander,92,Dale Thomas,4,3,1
183,Simon Alexander,225247539,Barry Knight,4,2,2
183,Simon Alexander,386517733,Ady Halley,4,4,0
183,Simon Alexander,573567936,Steve Marriott,4,2,2
202,Bob Firth,873916947,Geoff Akehurst,4,3,1
235,Derek Conley,503528426,Larry Maloney,4,3,1
239,Mick Lucas,279,Tony Slark,4,3,1
278,Dave Fairbairn,915035871,Kevin Graysmark,4,2,2
315,Peter Stevens,579164381,Danny Cattell,4,2,2
365,Dan Buckwell,5820499,Paul Bartlett,4,4,0
365,Dan Buckwell,666735933,Mike Collier,4,2,2
384,Bryan Beck,978156264,Bob Paine,4,3,1
394,Alan Burchell,266591683,Chris Roche,4,3,1
403,Joe Marcuson,745152759,Kevin Jewell,4,2,2
11133032,Simon Dent,278731588,Lester Grice,4,4,0
11133032,Simon Dent,766684900,John Gillard,4,3,1
11133032,Simon Dent,802242736,Steve Hughes,4,3,1
11133032,Simon Dent,963958265,Rodney Moogan,4,3,1
16253983,Tony Simmonds,327948141,Ross Etheridge,4,3,1
26970170,Kai Michael,567316488,Lee Millyard,4,3,1
26970170,Kai Michael,802242736,Steve Hughes,4,2,2
26970170,Kai Michael,963958265,Rodney Moogan,4,3,1
28382047,Steve Harrington,537640521,Ian Stoner,4,3,1
28382047,Steve Harrington,844676925,Kieran Williams,4,2,2
32061370,Toby Prince-Iles,160950731,Locky McCurdy,4,4,0
32061370,Toby Prince-Iles,349269645,Barry Thornton,4,2,2
32061370,Toby Prince-Iles,498330760,Mo Collins,4,3,1
32061370,Toby Prince-Iles,688252012,Sean Cooper,4,2,2
32061370,Toby Prince-Iles,966905561,Tony Dade,4,2,2
34787509,Dave McCarthy,646410961,Paul Scorer,4,4,0
39289507,Mick Laughlin,32061370,Toby Prince-Iles,4,4,0
41098823,Mikey Booker,124523642,Tom Hayes,4,3,1
59858690,James Constable,96354463,Rob Pickard,4,2,2
60575249,Ash Thurmer,59858690,James Constable,4,3,1
60575249,Ash Thurmer,326342962,Geoff Randall,4,2,2
60575249,Ash Thurmer,506581042,Glen Dartnell,4,2,2
60575249,Ash Thurmer,948504778,Jon Fordham,4,2,2
70159035,Peter Rea,426236650,Dave Parrott,4,4,0
70159035,Peter Rea,953512654,Les Berry,4,4,0
70159035,Peter Rea,966905561,Tony Dade,4,4,0
70159035,Peter Rea,978156264,Bob Paine,4,4,0
96103077,Paul Norris,384960657,Dave Lewney,4,4,0
96103077,Paul Norris,515186402,Ben Evans,4,2,2
96103077,Paul Norris,523395206,Jamie Lashmar,4,4,0
96354463,Rob Pickard,34787509,Dave McCarthy,4,3,1
101751030,Simon Uddin,440,Gordon Carter,4,3,1
110039677,Mick Miller,171346729,Des Heasman,4,2,2
110039677,Mick Miller,174147986,Lee Cliff,4,2,2
112887737,Pip Akehurst,412256116,Andy Sutton,4,3,1
112887737,Pip Akehurst,574248035,Tony Mulhern,4,4,0
112887737,Pip Akehurst,721321839,Matt Peake,4,4,0
112887737,Pip Akehurst,836895047,Ian McKay,4,4,0
114184042,Ian Smith,202090738,Alan Head,4,3,1
114184042,Ian Smith,412256116,Andy Sutton,4,2,2
114319292,Oliver Gorrod,833156731,Jez Saunders,4,2,2
123792666,Jamie Thomas,319057545,Brendan Lambe,4,4,0
123792666,Jamie Thomas,728690686,Rick Rothschild,4,3,1
124523642,Tom Hayes,179,Mick Jones,4,3,1
124523642,Tom Hayes,963206772,Dean Moore,4,3,1
133207947,Jake Richardson,617751649,Lee Simpson,4,2,2
133207947,Jake Richardson,662568995,Rob Wykes,4,2,2
133207947,Jake Richardson,802242736,Steve Hughes,4,3,1
133207947,Jake Richardson,809568302,Mark Johnson,4,2,2
133207947,Jake Richardson,947143243,Chris Davis,4,4,0
144293731,Simon Parry,809568302,Mark Johnson,4,2,2
146404254,Randall Griffiths,287057630,Darren Hearn,4,4,0
146404254,Randall Griffiths,394906196,Mick Mabbitt,4,3,1
146404254,Randall Griffiths,899206834,Jez Downs,4,2,2
160950731,Locky McCurdy,440,Gordon Carter,4,3,1
160950731,Locky McCurdy,719124015,Tony Power,4,2,2
171346729,Des Heasman,455401154,Kai Ellis,4,2,2
172646809,Robin Powell,804381932,Ryan Harman,4,3,1
174147986,Lee Cliff,199,Mark Holloway,4,3,1
174147986,Lee Cliff,319057545,Brendan Lambe,4,3,1
216787426,Jack Perrin,845758589,Charlie James,4,3,1
223983583,Carl Wentworth,936624299,Peter Gallant,4,2,2
225850882,John McLellan,177,John Regan,4,4,0
225850882,John McLellan,436708540,Bob Henley,4,3,1
225850882,John McLellan,719124015,Tony Power,4,3,1
225850882,John McLellan,954080507,Sam Corsby,4,3,1
227209116,Peter Rawlinson,978156264,Bob Paine,4,4,0
229719541,Scott Manning,28382047,Steve Harrington,4,4,0
229719541,Scott Manning,922772801,Nick Buonanno,4,4,0
229719541,Scott Manning,951468676,Steve Burchett,4,4,0
231445676,Tony Paice,293577764,Dave Crosskey,4,2,2
231445676,Tony Paice,820231590,Alan Rook,4,4,0
246154671,Alan Gunn,239,Mick Lucas,4,3,1
266477517,Tony Baxter,649240057,Mike Childs,4,4,0
266477517,Tony Baxter,978156264,Bob Paine,4,4,0
266591683,Chris Roche,235,Derek Conley,4,4,0
266591683,Chris Roche,836895047,Ian McKay,4,2,2
271464632,Paul Phillips,613893140,Matt Warner,4,3,1
275738778,John Da Silva,225247539,Barry Knight,4,3,1
278731588,Lester Grice,529382351,Greg Foat,4,4,0
278731588,Lester Grice,748064029,Paul Hughes,4,3,1
278731588,Lester Grice,963958265,Rodney Moogan,4,4,0
279543944,Peter Maurice,567316488,Lee Millyard,4,2,2
289915561,Craig Dummer,341869673,Nigel Stilwell,4,2,2
293577764,Dave Crosskey,266477517,Tony Baxter,4,4,0
293577764,Dave Crosskey,495939788,Tyrone Davis,4,4,0
293577764,Dave Crosskey,978156264,Bob Paine,4,3,1
294944526,Rob Teanby,978156264,Bob Paine,4,4,0
301960429,Brian Collins,670034050,John Muzio,4,4,0
301960429,Brian Collins,688778183,Dean Paice,4,3,1
307140835,Tony Strange,9,Michael Cheung,4,4,0
307140835,Tony Strange,809568302,Mark Johnson,4,3,1
319057545,Brendan Lambe,728690686,Rick Rothschild,4,2,2
319057545,Brendan Lambe,732415457,Barry Hall,4,2,2
323907964,Russ Hughes,112887737,Pip Akehurst,4,3,1
323907964,Russ Hughes,619390728,Steve Stylianou,4,2,2
323907964,Russ Hughes,766684900,John Gillard,4,2,2
323907964,Russ Hughes,797962517,Dave Lewis,4,4,0
326342962,Geoff Randall,112887737,Pip Akehurst,4,3,1
326342962,Geoff Randall,719124015,Tony Power,4,3,1
326342962,Geoff Randall,954080507,Sam Corsby,4,2,2
327948141,Ross Etheridge,535728699,Fred Cooper,4,3,1
327948141,Ross Etheridge,880982797,Ray Hunter,4,2,2
345558874,Zack Richardson,600385553,Darren Welfare,4,3,1
345558874,Zack Richardson,748064029,Paul Hughes,4,4,0
345558874,Zack Richardson,963958265,Rodney Moogan,4,4,0
349269645,Barry Thornton,529382351,Greg Foat,4,2,2
349269645,Barry Thornton,537640521,Ian Stoner,4,2,2
349269645,Barry Thornton,612265840,Paul Honeysett,4,4,0
356397577,David Morgan,646410961,Paul Scorer,4,2,2
356397577,David Morgan,748064029,Paul Hughes,4,2,2
360777082,Mark Bishop,319057545,Brendan Lambe,4,3,1
360777082,Mark Bishop,484159049,Tommy Wright,4,3,1
360777082,Mark Bishop,833156731,Jez Saunders,4,3,1
364867274,Dave Lucking,436708540,Bob Henley,4,2,2
382970973,Paul Shaw,174147986,Lee Cliff,4,3,1
386517733,Ady Halley,41461520,Luke Pooley,4,3,1
390364577,Mark Bright,133207947,Jake Richardson,4,4,0
392533233,Jack Wright,809984729,Neil Scutt,4,3,1
409212679,Mark Chapman,866506631,Mark Smith,4,2,2
411473516,Ray Canham,69745818,Ian Bowles,4,4,0
411473516,Ray Canham,291816585,Jim Somers,4,3,1
411473516,Ray Canham,349269645,Barry Thornton,4,3,1
411473516,Ray Canham,430890681,Malcolm Cooper,4,2,2
412256116,Andy Sutton,121,Mike Barnett,4,3,1
412256116,Andy Sutton,124,Dave Tristram,4,4,0
412256116,Andy Sutton,444350794,Richard Freeman,4,3,1
415524562,Dave King,501266206,David Fox,4,4,0
426009127,Bav Patel,809568302,Mark Johnson,4,3,1
426009127,Bav Patel,948504778,Jon Fordham,4,3,1
428102632,Anthony Flynn,506581042,Glen Dartnell,4,3,1
428102632,Anthony Flynn,766684900,John Gillard,4,2,2
430890681,Malcolm Cooper,788605510,Mark Rose,4,3,1
436708540,Bob Henley,153,Tony Leach,4,3,1
436708540,Bob Henley,670034050,John Muzio,4,3,1
444639447,Andy Wong,802242736,Steve Hughes,4,3,1
455401154,Kai Ellis,641692362,Bob Taylor,4,3,1
484159049,Tommy Wright,114319292,Oliver Gorrod,4,4,0
484159049,Tommy Wright,535728699,Fred Cooper,4,2,2
490170224,Jamie Matthews,56252722,Dave Pither,4,3,1
490170224,Jamie Matthews,574248035,Tony Mulhern,4,3,1
490170224,Jamie Matthews,951468676,Steve Burchett,4,2,2
493830161,Luke Strevens,732415457,Barry Hall,4,2,2
501266206,David Fox,845758589,Charlie James,4,2,2
503528426,Larry Maloney,529382351,Greg Foat,4,4,0
506581042,Glen Dartnell,341869673,Nigel Stilwell,4,3,1
506581042,Glen Dartnell,748064029,Paul Hughes,4,2,2
506581042,Glen Dartnell,963958265,Rodney Moogan,4,3,1
515186402,Ben Evans,748064029,Paul Hughes,4,2,2
523395206,Jamie Lashmar,6,Dan Stirling,4,3,1
523395206,Jamie Lashmar,26970170,Kai Michael,4,3,1
523395206,Jamie Lashmar,34787509,Dave McCarthy,4,4,0
523395206,Jamie Lashmar,341869673,Nigel Stilwell,4,4,0
523395206,Jamie Lashmar,515186402,Ben Evans,4,3,1
523395206,Jamie Lashmar,619390728,Steve Stylianou,4,2,2
523395206,Jamie Lashmar,746406369,Loz O'Keefe,4,3,1
523395206,Jamie Lashmar,794630189,Mark Coles,4,2,2
529382351,Greg Foat,291816585,Jim Somers,4,4,0
529382351,Greg Foat,978156264,Bob Paine,4,2,2
535728699,Fred Cooper,953512654,Les Berry,4,4,0
537640521,Ian Stoner,971308746,Clive Harman,4,3,1
556095121,Tom Wright,688252012,Sean Cooper,4,2,2
561171273,Andy Norman,278731588,Lester Grice,4,4,0
561171273,Andy Norman,384960657,Dave Lewney,4,3,1
573567936,Steve Marriott,943667183,John Stone,4,2,2
573567936,Steve Marriott,953512654,Les Berry,4,3,1
574248035,Tony Mulhern,436708540,Bob Henley,4,3,1
574248035,Tony Mulhern,670034050,John Muzio,4,2,2
574248035,Tony Mulhern,836895047,Ian McKay,4,2,2
574248035,Tony Mulhern,954080507,Sam Corsby,4,2,2
598846718,Ben Sorrell,402257815,Jim Cumming,4,3,1
600385553,Darren Welfare,76,David Rea,4,3,1
600385553,Darren Welfare,800114325,Roger Whiteley,4,3,1
608140548,David Gillingham,225850882,John McLellan,4,4,0
608140548,David Gillingham,323907964,Russ Hughes,4,3,1
608140548,David Gillingham,574248035,Tony Mulhern,4,3,1
608140548,David Gillingham,721321839,Matt Peake,4,4,0
613893140,Matt Warner,537640521,Ian Stoner,4,3,1
617751649,Lee Simpson,112887737,Pip Akehurst,4,4,0
617751649,Lee Simpson,356397577,David Morgan,4,3,1
617751649,Lee Simpson,646410961,Paul Scorer,4,3,1
617751649,Lee Simpson,752709358,Chris Mason,4,2,2
617751649,Lee Simpson,797962517,Dave Lewis,4,3,1
617751649,Lee Simpson,948504778,Jon Fordham,4,4,0
617751649,Lee Simpson,963958265,Rodney Moogan,4,4,0
619390728,Steve Stylianou,754250007,Freddie Blunden,4,2,2
654650203,Alan O'Sullivan,412256116,Andy Sutton,4,4,0
654650203,Alan O'Sullivan,970786910,Kevin Sorrell,4,2,2
662568995,Rob Wykes,748064029,Paul Hughes,4,2,2
662568995,Rob Wykes,809568302,Mark Johnson,4,2,2
666735933,Mike Collier,748064029,Paul Hughes,4,4,0
669385277,Steve Towler,704007508,Alan Muir,4,2,2
670034050,John Muzio,845758589,Charlie James,4,4,0
670034050,John Muzio,899206834,Jez Downs,4,3,1
670256222,Connor Anderson,455401154,Kai Ellis,4,3,1
670256222,Connor Anderson,646410961,Paul Scorer,4,3,1
670256222,Connor Anderson,764177688,Barry Martin,4,2,2
670256222,Connor Anderson,794630189,Mark Coles,4,4,0
670256222,Connor Anderson,797962517,Dave Lewis,4,2,2
670870044,David Flanagan,732415457,Barry Hall,4,2,2
677110925,Jake Dunstall,866506631,Mark Smith,4,2,2
680442672,Scott Lawson,963958265,Rodney Moogan,4,2,2
688252012,Sean Cooper,867613624,Ian Dunhill,4,3,1
688778183,Dean Paice,495939788,Tyrone Davis,4,4,0
688778183,Dean Paice,529382351,Greg Foat,4,4,0
688778183,Dean Paice,535728699,Fred Cooper,4,4,0
688778183,Dean Paice,880982797,Ray Hunter,4,3,1
688778183,Dean Paice,943667183,John Stone,4,3,1
704007508,Alan Muir,32061370,Toby Prince-Iles,4,3,1
713064363,John Trory,417786644,Eddie Collins,4,3,1
717256135,Trevor Pickard,114184042,Ian Smith,4,3,1
717256135,Trevor Pickard,225850882,John McLellan,4,3,1
717256135,Trevor Pickard,719124015,Tony Power,4,4,0
719124015,Tony Power,225247539,Barry Knight,4,3,1
719124015,Tony Power,736672590,Dean Perry,4,2,2
719124015,Tony Power,873916947,Geoff Akehurst,4,3,1
732415457,Barry Hall,535728699,Fred Cooper,4,3,1
732415457,Barry Hall,867613624,Ian Dunhill,4,2,2
733453947,Phil Canham,394906196,Mick Mabbitt,4,4,0
733453947,Phil Canham,688252012,Sean Cooper,4,3,1
736672590,Dean Perry,954080507,Sam Corsby,4,2,2
745152759,Kevin Jewell,978156264,Bob Paine,4,2,2
746406369,Loz O'Keefe,266477517,Tony Baxter,4,4,0
748064029,Paul Hughes,426009127,Bav Patel,4,3,1
752709358,Chris Mason,133207947,Jake Richardson,4,3,1
752709358,Chris Mason,764177688,Barry Martin,4,2,2
754250007,Freddie Blunden,26970170,Kai Michael,4,4,0
754250007,Freddie Blunden,96354463,Rob Pickard,4,3,1
754250007,Freddie Blunden,323907964,Russ Hughes,4,3,1
754250007,Freddie Blunden,662568995,Rob Wykes,4,3,1
764177688,Barry Martin,957784480,Harry Banks,4,3,1
766684900,John Gillard,278731588,Lester Grice,4,4,0
766684900,John Gillard,646410961,Paul Scorer,4,4,0
766684900,John Gillard,666735933,Mike Collier,4,3,1
766684900,John Gillard,957784480,Harry Banks,4,3,1
773216781,Sean Payne,409212679,Mark Chapman,4,4,0
788605510,Mark Rose,688252012,Sean Cooper,4,4,0
794630189,Mark Coles,11133032,Simon Dent,4,3,1
794630189,Mark Coles,957784480,Harry Banks,4,4,0
797962517,Dave Lewis,26970170,Kai Michael,4,3,1
800114325,Roger Whiteley,266591683,Chris Roche,4,4,0
800114325,Roger Whiteley,279543944,Peter Maurice,4,4,0
800114325,Roger Whiteley,567316488,Lee Millyard,4,4,0
805165161,Steve Owen,179,Mick Jones,4,3,1
809568302,Mark Johnson,608140548,David Gillingham,4,3,1
809647573,John Taylor,954080507,Sam Corsby,4,4,0
809984729,Neil Scutt,899206834,Jez Downs,4,2,2
815023707,David Senior,649240057,Mike Childs,4,3,1
815023707,David Senior,978156264,Bob Paine,4,2,2
825399596,Pat Adams,278731588,Lester Grice,4,4,0
831214643,Tony Shipley,108,John Wooller,4,4,0
831214643,Tony Shipley,291816585,Jim Somers,4,4,0
831214643,Tony Shipley,567316488,Lee Millyard,4,4,0
833156731,Jez Saunders,394906196,Mick Mabbitt,4,3,1
833156731,Jez Saunders,866506631,Mark Smith,4,2,2
835713833,Olly Stewart,613893140,Matt Warner,4,4,0
835713833,Olly Stewart,733453947,Phil Canham,4,4,0
845537273,Dave Gridley,173,Dave Alderton,4,3,1
845537273,Dave Gridley,954080507,Sam Corsby,4,4,0
858283721,Dave Dunstall,278,Dave Fairbairn,4,3,1
866506631,Mark Smith,936624299,Peter Gallant,4,4,0
873916947,Geoff Akehurst,225247539,Barry Knight,4,4,0
880982797,Ray Hunter,970786910,Kevin Sorrell,4,2,2
889234854,Paul Smith,409212679,Mark Chapman,4,3,1
899206834,Jez Downs,394906196,Mick Mabbitt,4,4,0
910809545,Blake Harman,32061370,Toby Prince-Iles,4,3,1
910809545,Blake Harman,535728699,Fred Cooper,4,3,1
922772801,Nick Buonanno,440,Gordon Carter,4,3,1
922772801,Nick Buonanno,929636592,Danny Wilson,4,4,0
929636592,Danny Wilson,936624299,Peter Gallant,4,2,2
936624299,Peter Gallant,351143642,Michael Palmer,4,3,1
936624299,Peter Gallant,430890681,Malcolm Cooper,4,3,1
936624299,Peter Gallant,953512654,Les Berry,4,2,2
943667183,John Stone,966905561,Tony Dade,4,3,1
947143243,Chris Davis,617751649,Lee Simpson,4,3,1
948504778,Jon Fordham,192463126,Gerry Lindsey,4,4,0
948504778,Jon Fordham,802242736,Steve Hughes,4,3,1
949603489,Pete Bennett,484159049,Tommy Wright,4,4,0
949603489,Pete Bennett,899206834,Jez Downs,4,3,1
954080507,Sam Corsby,213264678,Martin Hall,4,3,1
954297832,Pav Sareen,957784480,Harry Banks,4,2,2
963206772,Dean Moore,394906196,Mick Mabbitt,4,4,0
963206772,Dean Moore,833156731,Jez Saunders,4,4,0
966905561,Tony Dade,39289507,Mick Laughlin,4,3,1
970786910,Kevin Sorrell,409212679,Mark Chapman,4,4,0
970786910,Kevin Sorrell,411473516,Ray Canham,4,3,1
971308746,Clive Harman,271464632,Paul Phillips,4,3,1
971308746,Clive Harman,573567936,Steve Marriott,4,3,1
971308746,Clive Harman,966905561,Tony Dade,4,4,0
974385564,Danny Booker,423038309,Ian Fennell,4,3,1
3,Neal Gozzett,802242736,Steve Hughes,3,3,0
5,Paul Osiecki,444639447,Andy Wong,3,3,0
6,Dan Stirling,136,Dave Bonwick,3,2,1
6,Dan Stirling,222,John Newnhan,3,2,1
6,Dan Stirling,809568302,Mark Johnson,3,3,0
6,Dan Stirling,963958265,Rodney Moogan,3,2,1
14,Michael West,136,Dave Bonwick,3,3,0
16,Mick Beck,202090738,Alan Head,3,3,0
16,Mick Beck,231445676,Tony Paice,3,3,0
16,Mick Beck,800114325,Roger Whiteley,3,2,1
17,Tony Funnell,202090738,Alan Head,3,2,1
38,Rob Bowden,845758589,Charlie James,3,3,0
61,Paul Gander,503528426,Larry Maloney,3,2,1
63,Colin Penson,947620111,Neil Cutler,3,2,1
65,Paul Hudson,503528426,Larry Maloney,3,3,0
70,Michael Turner-Lee,503528426,Larry Maloney,3,2,1
80,Dave Wells,291198629,Tony Burt,3,2,1
80,Dave Wells,556095121,Tom Wright,3,2,1
80,Dave Wells,978156264,Bob Paine,3,3,0
81,Nick Bollingbroke,713064363,John Trory,3,2,1
89,Mike Atkins,503528426,Larry Maloney,3,3,0
92,Dale Thomas,32061370,Toby Prince-Iles,3,2,1
96,Dave Kellett,415524562,Dave King,3,3,0
96,Dave Kellett,612265840,Paul Honeysett,3,2,1
97,Shaun Winsor,573567936,Steve Marriott,3,2,1
98,Tony Collins,282,Adam Harrild,3,2,1
98,Tony Collins,394906196,Mick Mabbitt,3,2,1
98,Tony Collins,415524562,Dave King,3,2,1
115,Jim Collins,114184042,Ian Smith,3,2,1
121,Mike Barnett,295,Graham Still,3,3,0
121,Mike Barnett,444350794,Richard Freeman,3,2,1
121,Mike Barnett,878576746,Jon Hall,3,3,0
121,Mike Barnett,974385564,Danny Booker,3,2,1
124,Dave Tristram,300,Graham Smart,3,3,0
124,Dave Tristram,337,Adam Williams,3,2,1
136,Dave Bonwick,608140548,David Gillingham,3,2,1
137,Ricky Beecham,222,John Newnhan,3,2,1
149,Tony Nealgrove,963206772,Dean Moore,3,2,1
171,Darren Bell,802242736,Steve Hughes,3,2,1
171,Darren Bell,837429850,Paul Beecham,3,3,0
174,Brian Grant,455401154,Kai Ellis,3,2,1
175,Dudley Rignall,300,Graham Smart,3,2,1
179,Mick Jones,677110925,Jake Dunstall,3,3,0
179,Mick Jones,968651401,Ryan Grover,3,2,1
181,Dave Roughley,202,Bob Firth,3,3,0
181,Dave Roughley,677110925,Jake Dunstall,3,3,0
182,Brian Welfare,83,Eric Gumbrell,3,3,0
182,Brian Welfare,35191252,Nigel Hayward,3,2,1
182,Brian Welfare,899206834,Jez Downs,3,2,1
183,Simon Alexander,35191252,Nigel Hayward,3,2,1
188,Phil Turner,417786644,Eddie Collins,3,3,0
193,Gary Goodman,754250007,Freddie Blunden,3,2,1
198,Chris Playford,231445676,Tony Paice,3,2,1
199,Mark Holloway,732415457,Barry Hall,3,2,1
223,Ollie Stalley,133,Darren Bradley,3,3,0
223,Ollie Stalley,802242736,Steve Hughes,3,2,1
236,Lee Garland,947620111,Neil Cutler,3,2,1
244,Dave Burchett,80,Dave Wells,3,3,0
247,Mick Justice,820231590,Alan Rook,3,3,0
247,Mick Justice,910809545,Blake Harman,3,2,1
247,Mick Justice,966905561,Tony Dade,3,2,1
272,Carlo Lupi,298,T. Harding,3,2,1
278,Dave Fairbairn,713064363,John Trory,3,3,0
282,Adam Harrild,495939788,Tyrone Davis,3,3,0
285,Pete Davie,102,Reece Childs,3,3,0
288,Pete Elliott,392533233,Jack Wright,3,2,1
294,Bob Tullett,805165161,Steve Owen,3,3,0
303,Graham Williard,177,John Regan,3,3,0
303,Graham Williard,641692362,Bob Taylor,3,2,1
307,Alister Morrison,38,Rob Bowden,3,3,0
307,Alister Morrison,275,Brian Balchin,3,2,1
307,Alister Morrison,225247539,Barry Knight,3,3,0
307,Alister Morrison,510918620,Robert Bowden,3,3,0
307,Alister Morrison,873916947,Geoff Akehurst,3,3,0
319,John Lojo,845537273,Dave Gridley,3,3,0
365,Dan Buckwell,90176364,David Page,3,2,1
365,Dan Buckwell,619390728,Steve Stylianou,3,2,1
365,Dan Buckwell,809568302,Mark Johnson,3,2,1
365,Dan Buckwell,957784480,Harry Banks,3,3,0
367,Chris Dolding,266591683,Chris Roche,3,3,0
367,Chris Dolding,279543944,Peter Maurice,3,2,1
372,Jim Race,440,Gordon Carter,3,2,1
374,Lloyd Saunders,884374645,Wayne Iddon,3,2,1
384,Bryan Beck,815023707,David Senior,3,3,0
384,Bryan Beck,820231590,Alan Rook,3,3,0
386,Sam Hains,498330760,Mo Collins,3,2,1
394,Alan Burchell,719124015,Tony Power,3,2,1
394,Alan Burchell,831214643,Tony Shipley,3,2,1
395,Herby Burchell,108,John Wooller,3,2,1
395,Herby Burchell,529382351,Greg Foat,3,2,1
395,Herby Burchell,661923191,Steve Gardner,3,3,0
431,Darren Jordan,802242736,Steve Hughes,3,3,0
442,Harvey Tuck,294944526,Rob Teanby,3,2,1
445,Lachlan Monroe,80,Dave Wells,3,3,0
445,Lachlan Monroe,649240057,Mike Childs,3,3,0
466,Ben Fielder,377,Gary Bradshaw,3,3,0
487,"Jim, Sr. Stevens",411473516,Ray Canham,3,2,1
496,Lucas Flux,820231590,Alan Rook,3,2,1
515,Simon Mackenzie,266477517,Tony Baxter,3,2,1
3508579,John Murray,598846718,Ben Sorrell,3,3,0
5820499,Paul Bartlett,26970170,Kai Michael,3,2,1
11133032,Simon Dent,34787509,Dave McCarthy,3,3,0
11133032,Simon Dent,60575249,Ash Thurmer,3,3,0
11133032,Simon Dent,506581042,Glen Dartnell,3,3,0
11133032,Simon Dent,732321233,Nathan Brooks,3,3,0
16253983,Tony Simmonds,278,Dave Fairbairn,3,3,0
16253983,Tony Simmonds,41098823,Mikey Booker,3,3,0
16253983,Tony Simmonds,225247539,Barry Knight,3,3,0
16253983,Tony Simmonds,669385277,Steve Towler,3,3,0
16253983,Tony Simmonds,680442672,Scott Lawson,3,2,1
16253983,Tony Simmonds,773216781,Sean Payne,3,2,1
16253983,Tony Simmonds,835713833,Olly Stewart,3,2,1
16253983,Tony Simmonds,878576746,Jon Hall,3,3,0
26970170,Kai Michael,90176364,David Page,3,2,1
27255501,Tom Lane,291198629,Tony Burt,3,2,1
27255501,Tom Lane,293577764,Dave Crosskey,3,2,1
28382047,Steve Harrington,356,Scott Harris,3,2,1
28382047,Steve Harrington,836895047,Ian McKay,3,2,1
32061370,Toby Prince-Iles,430890681,Malcolm Cooper,3,2,1
32061370,Toby Prince-Iles,495939788,Tyrone Davis,3,3,0
32061370,Toby Prince-Iles,537640521,Ian Stoner,3,2,1
32061370,Toby Prince-Iles,674307680,Neil McCafferty,3,2,1
32061370,Toby Prince-Iles,809984729,Neil Scutt,3,2,1
32061370,Toby Prince-Iles,815023707,David Senior,3,2,1
34787509,Dave McCarthy,662568995,Rob Wykes,3,3,0
34787509,Dave McCarthy,688252012,Sean Cooper,3,3,0
39289507,Mick Laughlin,319057545,Brendan Lambe,3,2,1
39289507,Mick Laughlin,649240057,Mike Childs,3,3,0
39289507,Mick Laughlin,815023707,David Senior,3,3,0
39289507,Mick Laughlin,899206834,Jez Downs,3,2,1
41098823,Mikey Booker,114184042,Ian Smith,3,3,0
41098823,Mikey Booker,163959771,Alex El-Deweiny,3,2,1
41098823,Mikey Booker,463709832,Danny Wong,3,2,1
41098823,Mikey Booker,490170224,Jamie Matthews,3,3,0
41098823,Mikey Booker,837429850,Paul Beecham,3,2,1
41461520,Luke Pooley,495939788,Tyrone Davis,3,3,0
45305697,John Barratt,41461520,Luke Pooley,3,2,1
45305697,John Barratt,612265840,Paul Honeysett,3,2,1
56252722,Dave Pither,246154671,Alan Gunn,3,2,1
56252722,Dave Pither,291816585,Jim Somers,3,2,1
56252722,Dave Pither,978156264,Bob Paine,3,3,0
59858690,James Constable,112887737,Pip Akehurst,3,2,1
59858690,James Constable,444639447,Andy Wong,3,2,1
69745818,Ian Bowles,386517733,Ady Halley,3,2,1
69745818,Ian Bowles,573567936,Steve Marriott,3,2,1
70159035,Peter Rea,69745818,Ian Bowles,3,3,0
70159035,Peter Rea,216787426,Jack Perrin,3,3,0
70159035,Peter Rea,598117191,Jerome Fowler,3,3,0
70159035,Peter Rea,688778183,Dean Paice,3,3,0
70159035,Peter Rea,852327692,Andy Fletcher,3,2,1
70159035,Peter Rea,936624299,Peter Gallant,3,3,0
76011459,Kane Harman,239,Mick Lucas,3,2,1
76011459,Kane Harman,287057630,Darren Hearn,3,3,0
76011459,Kane Harman,360777082,Mark Bishop,3,2,1
76011459,Kane Harman,394906196,Mick Mabbitt,3,3,0
76011459,Kane Harman,567624732,Dave Brampton,3,2,1
76011459,Kane Harman,612265840,Paul Honeysett,3,2,1
76011459,Kane Harman,649240057,Mike Childs,3,2,1
76011459,Kane Harman,669385277,Steve Towler,3,3,0
83590771,Nick Brayne,719124015,Tony Power,3,3,0
90176364,David Page,5820499,Paul Bartlett,3,2,1
96103077,Paul Norris,34787509,Dave McCarthy,3,3,0
96103077,Paul Norris,133207947,Jake Richardson,3,3,0
96103077,Paul Norris,307140835,Tony Strange,3,3,0
96103077,Paul Norris,428102632,Anthony Flynn,3,3,0
96103077,Paul Norris,463709832,Danny Wong,3,3,0
96103077,Paul Norris,480772114,Kevin Ward,3,3,0
96103077,Paul Norris,797962517,Dave Lewis,3,3,0
101751030,Simon Uddin,498330760,Mo Collins,3,2,1
101751030,Simon Uddin,676753614,Don James,3,2,1
110039677,Mick Miller,503528426,Larry Maloney,3,2,1
110039677,Mick Miller,820231590,Alan Rook,3,2,1
112887737,Pip Akehurst,654650203,Alan O'Sullivan,3,3,0
112887737,Pip Akehurst,704007508,Alan Muir,3,3,0
112887737,Pip Akehurst,734416600,DON PENALVER,3,3,0
114184042,Ian Smith,279543944,Peter Maurice,3,2,1
114184042,Ian Smith,567316488,Lee Millyard,3,2,1
114184042,Ian Smith,704007508,Alan Muir,3,2,1
117247901,Dave Verey,173,Dave Alderton,3,2,1
117247901,Dave Verey,180,Pat Sweeney,3,3,0
120138229,Adam Butler,726498878,Grigory Yashkov,3,2,1
120138229,Adam Butler,848997254,Tom Parker,3,2,1
124523642,Tom Hayes,490170224,Jamie Matthews,3,2,1
124523642,Tom Hayes,704007508,Alan Muir,3,2,1
133207947,Jake Richardson,444639447,Andy Wong,3,3,0
141540226,Pete Hazell,279543944,Peter Maurice,3,3,0
144776055,Brian Wilkes,480154054,Jim Dunstall,3,2,1
144776055,Brian Wilkes,506320151,Frank Taylor,3,2,1
144776055,Brian Wilkes,598846718,Ben Sorrell,3,3,0
144776055,Brian Wilkes,713064363,John Trory,3,3,0
144776055,Brian Wilkes,880982797,Ray Hunter,3,2,1
146404254,Randall Griffiths,971308746,Clive Harman,3,3,0
147556923,Hong Ming Lee,717256135,Trevor Pickard,3,3,0
160950731,Locky McCurdy,266477517,Tony Baxter,3,2,1
160950731,Locky McCurdy,506320151,Frank Taylor,3,2,1
160950731,Locky McCurdy,567316488,Lee Millyard,3,2,1
160950731,Locky McCurdy,880982797,Ray Hunter,3,2,1
160950731,Locky McCurdy,936624299,Peter Gallant,3,2,1
171346729,Des Heasman,174,Brian Grant,3,2,1
171346729,Des Heasman,319,John Lojo,3,2,1
171346729,Des Heasman,487,"Jim, Sr. Stevens",3,3,0
171346729,Des Heasman,27255501,Tom Lane,3,3,0
171346729,Des Heasman,32061370,Toby Prince-Iles,3,3,0
171346729,Des Heasman,223983583,Carl Wentworth,3,2,1
171346729,Des Heasman,535728699,Fred Cooper,3,3,0
172646809,Robin Powell,216787426,Jack Perrin,3,2,1
174147986,Lee Cliff,121,Mike Barnett,3,3,0
174147986,Lee Cliff,319,John Lojo,3,2,1
174147986,Lee Cliff,3508579,John Murray,3,2,1
174147986,Lee Cliff,225850882,John McLellan,3,2,1
174147986,Lee Cliff,279543944,Peter Maurice,3,3,0
174147986,Lee Cliff,535728699,Fred Cooper,3,3,0
174147986,Lee Cliff,688252012,Sean Cooper,3,2,1
174147986,Lee Cliff,733453947,Phil Canham,3,2,1
174147986,Lee Cliff,963206772,Dean Moore,3,3,0
202090738,Alan Head,235,Derek Conley,3,2,1
202090738,Alan Head,661923191,Steve Gardner,3,2,1
204951513,Mike Holding,239,Mick Lucas,3,3,0
213264678,Martin Hall,301,Terry Grant,3,2,1
216787426,Jack Perrin,351143642,Michael Palmer,3,2,1
216787426,Jack Perrin,449331249,Dan Tanner,3,3,0
216787426,Jack Perrin,613893140,Matt Warner,3,2,1
223983583,Carl Wentworth,216787426,Jack Perrin,3,2,1
223983583,Carl Wentworth,537640521,Ian Stoner,3,2,1
223983583,Carl Wentworth,745152759,Kevin Jewell,3,2,1
223983583,Carl Wentworth,978156264,Bob Paine,3,3,0
225850882,John McLellan,174,Brian Grant,3,2,1
225850882,John McLellan,455401154,Kai Ellis,3,2,1
225850882,John McLellan,866506631,Mark Smith,3,3,0
225850882,John McLellan,873916947,Geoff Akehurst,3,2,1
229719541,Scott Manning,378,Simon Howe,3,2,1
229719541,Scott Manning,39289507,Mick Laughlin,3,3,0
229719541,Scott Manning,349269645,Barry Thornton,3,3,0
229719541,Scott Manning,382970973,Paul Shaw,3,2,1
229719541,Scott Manning,392533233,Jack Wright,3,3,0
229719541,Scott Manning,410854609,Dave Lowe,3,2,1
229719541,Scott Manning,506581042,Glen Dartnell,3,2,1
229719541,Scott Manning,670870044,David Flanagan,3,2,1
229719541,Scott Manning,844676925,Kieran Williams,3,2,1
231445676,Tony Paice,65,Paul Hudson,3,3,0
231445676,Tony Paice,89,Mike Atkins,3,3,0
231445676,Tony Paice,395,Herby Burchell,3,3,0
231445676,Tony Paice,41461520,Luke Pooley,3,3,0
231445676,Tony Paice,114184042,Ian Smith,3,3,0
231445676,Tony Paice,349269645,Barry Thornton,3,3,0
231445676,Tony Paice,363402934,Rod Phillippe,3,3,0
231445676,Tony Paice,495939788,Tyrone Davis,3,3,0
231445676,Tony Paice,503528426,Larry Maloney,3,2,1
258549102,Tony Lee,279543944,Peter Maurice,3,2,1
266477517,Tony Baxter,80,Dave Wells,3,2,1
266591683,Chris Roche,108,John Wooller,3,3,0
266591683,Chris Roche,236,Lee Garland,3,3,0
266591683,Chris Roche,279543944,Peter Maurice,3,2,1
271464632,Paul Phillips,32061370,Toby Prince-Iles,3,2,1
271464632,Paul Phillips,963206772,Dean Moore,3,2,1
275738778,John Da Silva,92,Dale Thomas,3,3,0
275738778,John Da Silva,183,Simon Alexander,3,2,1
275738778,John Da Silva,394906196,Mick Mabbitt,3,3,0
275738778,John Da Silva,480154054,Jim Dunstall,3,2,1
275738778,John Da Silva,573567936,Steve Marriott,3,3,0
275738778,John Da Silva,866506631,Mark Smith,3,2,1
278731588,Lester Grice,70,Michael Turner-Lee,3,2,1
278731588,Lester Grice,144293731,Simon Parry,3,2,1
278731588,Lester Grice,192463126,Gerry Lindsey,3,3,0
278731588,Lester Grice,293122482,Stuart Maplesden,3,2,1
278731588,Lester Grice,384960657,Dave Lewney,3,2,1
278731588,Lester Grice,444639447,Andy Wong,3,3,0
278731588,Lester Grice,515186402,Ben Evans,3,2,1
278731588,Lester Grice,654650203,Alan O'Sullivan,3,3,0
278731588,Lester Grice,683709119,Ronnie Beard,3,3,0
278731588,Lester Grice,717256135,Trevor Pickard,3,2,1
278731588,Lester Grice,800114325,Roger Whiteley,3,3,0
279543944,Peter Maurice,444350794,Richard Freeman,3,2,1
279543944,Peter Maurice,649240057,Mike Childs,3,2,1
279543944,Peter Maurice,922772801,Nick Buonanno,3,2,1
287057630,Darren Hearn,394906196,Mick Mabbitt,3,3,0
287057630,Darren Hearn,444350794,Richard Freeman,3,2,1
288891270,Lewis Copping,573567936,Steve Marriott,3,3,0
289915561,Craig Dummer,957784480,Harry Banks,3,2,1
291816585,Jim Somers,223983583,Carl Wentworth,3,2,1
293577764,Dave Crosskey,69745818,Ian Bowles,3,3,0
293577764,Dave Crosskey,430890681,Malcolm Cooper,3,2,1
293577764,Dave Crosskey,567624732,Dave Brampton,3,2,1
293577764,Dave Crosskey,966905561,Tony Dade,3,2,1
294944526,Rob Teanby,377,Gary Bradshaw,3,3,0
294944526,Rob Teanby,351143642,Michael Palmer,3,2,1
294944526,Rob Teanby,966905561,Tony Dade,3,3,0
301960429,Brian Collins,223983583,Carl Wentworth,3,3,0
301960429,Brian Collins,225247539,Barry Knight,3,3,0
301960429,Brian Collins,951468676,Steve Burchett,3,2,1
306438070,Martin Stocker,114184042,Ian Smith,3,3,0
307140835,Tony Strange,5820499,Paul Bartlett,3,3,0
307140835,Tony Strange,26970170,Kai Michael,3,2,1
307140835,Tony Strange,428102632,Anthony Flynn,3,2,1
307140835,Tony Strange,608140548,David Gillingham,3,3,0
307140835,Tony Strange,670256222,Connor Anderson,3,3,0
307140835,Tony Strange,794630189,Mark Coles,3,2,1
319057545,Brendan Lambe,456,Daniel Marcantonio,3,3,0
319057545,Brendan Lambe,287057630,Darren Hearn,3,2,1
319057545,Brendan Lambe,535728699,Fred Cooper,3,3,0
319057545,Brendan Lambe,884374645,Wayne Iddon,3,3,0
323907964,Russ Hughes,133207947,Jake Richardson,3,3,0
323907964,Russ Hughes,629014363,Lee Shepherd,3,2,1
323907964,Russ Hughes,666735933,Mike Collier,3,3,0
323907964,Russ Hughes,670256222,Connor Anderson,3,2,1
323907964,Russ Hughes,732321233,Nathan Brooks,3,3,0
323907964,Russ Hughes,876526526,Ash Bull,3,2,1
323907964,Russ Hughes,957784480,Harry Banks,3,3,0
326225304,Ian Raeburn,804381932,Ryan Harman,3,2,1
326342962,Geoff Randall,34787509,Dave McCarthy,3,3,0
326342962,Geoff Randall,110039677,Mick Miller,3,2,1
326342962,Geoff Randall,258340682,John Derret,3,3,0
326342962,Geoff Randall,670034050,John Muzio,3,2,1
326342962,Geoff Randall,721321839,Matt Peake,3,3,0
326342962,Geoff Randall,800114325,Roger Whiteley,3,2,1
326342962,Geoff Randall,802242736,Steve Hughes,3,2,1
327948141,Ross Etheridge,173,Dave Alderton,3,2,1
327948141,Ross Etheridge,899206834,Jez Downs,3,2,1
341869673,Nigel Stilwell,11133032,Simon Dent,3,2,1
341869673,Nigel Stilwell,59858690,James Constable,3,2,1
341869673,Nigel Stilwell,654650203,Alan O'Sullivan,3,2,1
341869673,Nigel Stilwell,680442672,Scott Lawson,3,2,1
341869673,Nigel Stilwell,754250007,Freddie Blunden,3,2,1
341869673,Nigel Stilwell,773216781,Sean Payne,3,3,0
345558874,Zack Richardson,136,Dave Bonwick,3,3,0
345558874,Zack Richardson,11133032,Simon Dent,3,2,1
345558874,Zack Richardson,278731588,Lester Grice,3,3,0
345558874,Zack Richardson,617751649,Lee Simpson,3,2,1
345558874,Zack Richardson,619390728,Steve Stylianou,3,2,1
349269645,Barry Thornton,293577764,Dave Crosskey,3,3,0
349269645,Barry Thornton,417786644,Eddie Collins,3,2,1
349269645,Barry Thornton,490170224,Jamie Matthews,3,2,1
351143642,Michael Palmer,183,Simon Alexander,3,3,0
351143642,Michael Palmer,833156731,Jez Saunders,3,3,0
351143642,Michael Palmer,889234854,Paul Smith,3,2,1
351143642,Michael Palmer,968651401,Ryan Grover,3,2,1
356397577,David Morgan,133207947,Jake Richardson,3,3,0
356397577,David Morgan,390364577,Mark Bright,3,2,1
356397577,David Morgan,426009127,Bav Patel,3,2,1
356397577,David Morgan,948504778,Jon Fordham,3,3,0
360777082,Mark Bishop,27255501,Tom Lane,3,3,0
360777082,Mark Bishop,146404254,Randall Griffiths,3,2,1
360777082,Mark Bishop,207592931,(shorty) Gediminas Aleksandravicius,3,2,1
360777082,Mark Bishop,394906196,Mick Mabbitt,3,3,0
360777082,Mark Bishop,402257815,Jim Cumming,3,3,0
360777082,Mark Bishop,444350794,Richard Freeman,3,2,1
360777082,Mark Bishop,736672590,Dean Perry,3,2,1
360777082,Mark Bishop,845758589,Charlie James,3,3,0
363402934,Rod Phillippe,254776886,Leighton Cole,3,2,1
364867274,Dave Lucking,351143642,Michael Palmer,3,2,1
382970973,Paul Shaw,275738778,John Da Silva,3,2,1
384960657,Dave Lewney,5820499,Paul Bartlett,3,2,1
384960657,Dave Lewney,34787509,Dave McCarthy,3,2,1
384960657,Dave Lewney,764177688,Barry Martin,3,2,1
386517733,Ady Halley,291816585,Jim Somers,3,3,0
386517733,Ady Halley,293577764,Dave Crosskey,3,2,1
386517733,Ady Halley,845758589,Charlie James,3,2,1
386517733,Ady Halley,943667183,John Stone,3,2,1
390364577,Mark Bright,506581042,Glen Dartnell,3,3,0
390364577,Mark Bright,748064029,Paul Hughes,3,2,1
390364577,Mark Bright,773216781,Sean Payne,3,2,1
392533233,Jack Wright,403,Joe Marcuson,3,2,1
392533233,Jack Wright,498330760,Mo Collins,3,2,1
392533233,Jack Wright,915035871,Kevin Graysmark,3,2,1
394906196,Mick Mabbitt,101751030,Simon Uddin,3,2,1
394906196,Mick Mabbitt,293577764,Dave Crosskey,3,2,1
394906196,Mick Mabbitt,889234854,Paul Smith,3,2,1
402257815,Jim Cumming,688252012,Sean Cooper,3,2,1
409212679,Mark Chapman,291198629,Tony Burt,3,2,1
409212679,Mark Chapman,319057545,Brendan Lambe,3,2,1
409212679,Mark Chapman,845758589,Charlie James,3,3,0
409212679,Mark Chapman,867613624,Ian Dunhill,3,2,1
410854609,Dave Lowe,28382047,Steve Harrington,3,3,0
410854609,Dave Lowe,676753614,Don James,3,3,0
411473516,Ray Canham,38,Rob Bowden,3,2,1
411473516,Ray Canham,278,Dave Fairbairn,3,2,1
411473516,Ray Canham,3508579,John Murray,3,3,0
411473516,Ray Canham,392533233,Jack Wright,3,3,0
411473516,Ray Canham,409212679,Mark Chapman,3,2,1
411473516,Ray Canham,510918620,Robert Bowden,3,2,1
411473516,Ray Canham,598846718,Ben Sorrell,3,2,1
411473516,Ray Canham,613893140,Matt Warner,3,2,1
411473516,Ray Canham,936624299,Peter Gallant,3,2,1
411473516,Ray Canham,953512654,Les Berry,3,3,0
412256116,Andy Sutton,124523642,Tom Hayes,3,2,1
412256116,Andy Sutton,171346729,Des Heasman,3,2,1
412256116,Andy Sutton,719124015,Tony Power,3,2,1
412256116,Andy Sutton,721321839,Matt Peake,3,2,1
412256116,Andy Sutton,866506631,Mark Smith,3,3,0
417786644,Eddie Collins,41461520,Luke Pooley,3,2,1
417786644,Eddie Collins,394906196,Mick Mabbitt,3,3,0
417786644,Eddie Collins,430890681,Malcolm Cooper,3,2,1
420230435,Jack Fielder,180,Pat Sweeney,3,3,0
420230435,Jack Fielder,948504778,Jon Fordham,3,2,1
426009127,Bav Patel,506581042,Glen Dartnell,3,3,0
426009127,Bav Patel,957784480,Harry Banks,3,3,0
426009127,Bav Patel,963958265,Rodney Moogan,3,2,1
428102632,Anthony Flynn,490170224,Jamie Matthews,3,3,0
428102632,Anthony Flynn,529382351,Greg Foat,3,3,0
428102632,Anthony Flynn,773216781,Sean Payne,3,3,0
430890681,Malcolm Cooper,247,Mick Justice,3,2,1
430890681,Malcolm Cooper,27255501,Tom Lane,3,3,0
430890681,Malcolm Cooper,266477517,Tony Baxter,3,2,1
430890681,Malcolm Cooper,287057630,Darren Hearn,3,2,1
430890681,Malcolm Cooper,820231590,Alan Rook,3,2,1
436708540,Bob Henley,704007508,Alan Muir,3,2,1
444339215,Steve Richards,845758589,Charlie James,3,2,1
444639447,Andy Wong,136,Dave Bonwick,3,2,1
455401154,Kai Ellis,121,Mike Barnett,3,2,1
455401154,Kai Ellis,297,S. Grogan,3,3,0
455401154,Kai Ellis,321,Mick Ingram,3,2,1
463709832,Danny Wong,836895047,Ian McKay,3,2,1
464085958,Gerwyn Bowen,436708540,Bob Henley,3,2,1
480772114,Kevin Ward,802242736,Steve Hughes,3,2,1
484159049,Tommy Wright,466,Ben Fielder,3,3,0
484159049,Tommy Wright,41098823,Mikey Booker,3,2,1
484159049,Tommy Wright,490170224,Jamie Matthews,3,3,0
484159049,Tommy Wright,537640521,Ian Stoner,3,3,0
484159049,Tommy Wright,820231590,Alan Rook,3,3,0
484159049,Tommy Wright,963206772,Dean Moore,3,3,0
490170224,Jamie Matthews,676753614,Don James,3,2,1
490170224,Jamie Matthews,873916947,Geoff Akehurst,3,3,0
493830161,Luke Strevens,174147986,Lee Cliff,3,3,0
493830161,Luke Strevens,724342701,Nigel Lilley,3,2,1
498330760,Mo Collins,417786644,Eddie Collins,3,3,0
501266206,David Fox,41461520,Luke Pooley,3,3,0
501266206,David Fox,101751030,Simon Uddin,3,2,1
506320151,Frank Taylor,225850882,John McLellan,3,2,1
506581042,Glen Dartnell,662568995,Rob Wykes,3,2,1
506581042,Glen Dartnell,922772801,Nick Buonanno,3,3,0
510918620,Robert Bowden,845758589,Charlie James,3,3,0
515177310,James Da Costa,688252012,Sean Cooper,3,2,1
515186402,Ben Evans,5820499,Paul Bartlett,3,3,0
515186402,Ben Evans,60575249,Ash Thurmer,3,2,1
515186402,Ben Evans,948504778,Jon Fordham,3,2,1
515186402,Ben Evans,957784480,Harry Banks,3,3,0
515186402,Ben Evans,963958265,Rodney Moogan,3,3,0
523395206,Jamie Lashmar,282,Adam Harrild,3,3,0
523395206,Jamie Lashmar,307140835,Tony Strange,3,2,1
523395206,Jamie Lashmar,323907964,Russ Hughes,3,2,1
523395206,Jamie Lashmar,490170224,Jamie Matthews,3,3,0
523395206,Jamie Lashmar,666735933,Mike Collier,3,3,0
529382351,Greg Foat,724342701,Nigel Lilley,3,2,1
535728699,Fred Cooper,98,Tony Collins,3,2,1
535728699,Fred Cooper,247,Mick Justice,3,2,1
535728699,Fred Cooper,39289507,Mick Laughlin,3,2,1
535728699,Fred Cooper,69745818,Ian Bowles,3,3,0
535728699,Fred Cooper,144776055,Brian Wilkes,3,2,1
535728699,Fred Cooper,291816585,Jim Somers,3,3,0
535728699,Fred Cooper,430890681,Malcolm Cooper,3,2,1
535728699,Fred Cooper,498330760,Mo Collins,3,3,0
535728699,Fred Cooper,674307680,Neil McCafferty,3,2,1
537640521,Ian Stoner,677110925,Jake Dunstall,3,2,1
537640521,Ian Stoner,867613624,Ian Dunhill,3,2,1
546362444,Anthony Trory,809984729,Neil Scutt,3,2,1
556095121,Tom Wright,316,Paul Redgate,3,3,0
561171273,Andy Norman,600385553,Darren Welfare,3,3,0
567316488,Lee Millyard,27255501,Tom Lane,3,2,1
567316488,Lee Millyard,271464632,Paul Phillips,3,2,1
567316488,Lee Millyard,319057545,Brendan Lambe,3,2,1
567316488,Lee Millyard,899206834,Jez Downs,3,2,1
567624732,Dave Brampton,98,Tony Collins,3,3,0
567624732,Dave Brampton,442,Harvey Tuck,3,3,0
567624732,Dave Brampton,291198629,Tony Burt,3,3,0
567624732,Dave Brampton,291816585,Jim Somers,3,3,0
567624732,Dave Brampton,401846353,Frank McHugh,3,3,0
567624732,Dave Brampton,573567936,Steve Marriott,3,2,1
567624732,Dave Brampton,613893140,Matt Warner,3,2,1
567624732,Dave Brampton,820231590,Alan Rook,3,3,0
567624732,Dave Brampton,867613624,Ian Dunhill,3,2,1
573567936,Steve Marriott,41461520,Luke Pooley,3,3,0
573567936,Steve Marriott,227209116,Peter Rawlinson,3,2,1
573567936,Steve Marriott,291816585,Jim Somers,3,2,1
573567936,Steve Marriott,293577764,Dave Crosskey,3,2,1
573567936,Steve Marriott,480154054,Jim Dunstall,3,2,1
573567936,Steve Marriott,713064363,John Trory,3,2,1
573567936,Steve Marriott,978156264,Bob Paine,3,3,0
574248035,Tony Mulhern,173,Dave Alderton,3,3,0
574248035,Tony Mulhern,704007508,Alan Muir,3,2,1
574248035,Tony Mulhern,866506631,Mark Smith,3,2,1
579164381,Danny Cattell,27255501,Tom Lane,3,2,1
579164381,Danny Cattell,613893140,Matt Warner,3,2,1
598117191,Jerome Fowler,144776055,Brian Wilkes,3,2,1
598552542,John Colgan,490170224,Jamie Matthews,3,2,1
600385553,Darren Welfare,63,Colin Penson,3,3,0
608140548,David Gillingham,16,Mick Beck,3,2,1
608140548,David Gillingham,272,Carlo Lupi,3,3,0
608140548,David Gillingham,412256116,Andy Sutton,3,3,0
608140548,David Gillingham,463709832,Danny Wong,3,3,0
608140548,David Gillingham,529382351,Greg Foat,3,3,0
608140548,David Gillingham,654650203,Alan O'Sullivan,3,3,0
608140548,David Gillingham,717256135,Trevor Pickard,3,3,0
608140548,David Gillingham,788605510,Mark Rose,3,3,0
608140548,David Gillingham,800114325,Roger Whiteley,3,3,0
608140548,David Gillingham,948504778,Jon Fordham,3,3,0
608140548,David Gillingham,954080507,Sam Corsby,3,3,0
612265840,Paul Honeysett,56252722,Dave Pither,3,3,0
612265840,Paul Honeysett,271464632,Paul Phillips,3,2,1
612265840,Paul Honeysett,291816585,Jim Somers,3,3,0
612265840,Paul Honeysett,649240057,Mike Childs,3,2,1
613893140,Matt Warner,127,Dave Turner,3,3,0
613893140,Matt Warner,28382047,Steve Harrington,3,3,0
613893140,Matt Warner,394906196,Mick Mabbitt,3,3,0
613893140,Matt Warner,402257815,Jim Cumming,3,3,0
613893140,Matt Warner,669385277,Steve Towler,3,2,1
613893140,Matt Warner,910809545,Blake Harman,3,2,1
613893140,Matt Warner,929636592,Danny Wilson,3,2,1
617751649,Lee Simpson,222,John Newnhan,3,3,0
617751649,Lee Simpson,60575249,Ash Thurmer,3,3,0
617751649,Lee Simpson,307140835,Tony Strange,3,3,0
617751649,Lee Simpson,390364577,Mark Bright,3,2,1
617751649,Lee Simpson,444639447,Andy Wong,3,2,1
619390728,Steve Stylianou,3,Neal Gozzett,3,2,1
619390728,Steve Stylianou,133,Darren Bradley,3,3,0
619390728,Steve Stylianou,670256222,Connor Anderson,3,2,1
619390728,Steve Stylianou,802242736,Steve Hughes,3,3,0
619390728,Steve Stylianou,963958265,Rodney Moogan,3,2,1
623613383,Chris Marsh,144776055,Brian Wilkes,3,2,1
629014363,Lee Shepherd,411473516,Ray Canham,3,3,0
641692362,Bob Taylor,175,Dudley Rignall,3,3,0
641692362,Bob Taylor,225850882,John McLellan,3,2,1
646410961,Paul Scorer,26970170,Kai Michael,3,3,0
646410961,Paul Scorer,60575249,Ash Thurmer,3,3,0
646410961,Paul Scorer,144293731,Simon Parry,3,2,1
646410961,Paul Scorer,515186402,Ben Evans,3,3,0
646410961,Paul Scorer,561171273,Andy Norman,3,2,1
646410961,Paul Scorer,680442672,Scott Lawson,3,2,1
646410961,Paul Scorer,732321233,Nathan Brooks,3,2,1
646410961,Paul Scorer,963958265,Rodney Moogan,3,3,0
649078882,Richard Barrett,412256116,Andy Sutton,3,2,1
649078882,Richard Barrett,574248035,Tony Mulhern,3,3,0
649240057,Mike Childs,239,Mick Lucas,3,2,1
649240057,Mike Childs,284,Ray Bradley,3,3,0
649240057,Mike Childs,327,Harold Franks,3,2,1
649240057,Mike Childs,676753614,Don James,3,2,1
654650203,Alan O'Sullivan,124523642,Tom Hayes,3,3,0
661923191,Steve Gardner,235,Derek Conley,3,2,1
661923191,Steve Gardner,503528426,Larry Maloney,3,3,0
662568995,Rob Wykes,59858690,James Constable,3,2,1
662568995,Rob Wykes,515186402,Ben Evans,3,2,1
666735933,Mike Collier,60575249,Ash Thurmer,3,2,1
666735933,Mike Collier,133207947,Jake Richardson,3,2,1
666735933,Mike Collier,752709358,Chris Mason,3,2,1
666735933,Mike Collier,957784480,Harry Banks,3,2,1
669385277,Steve Towler,327948141,Ross Etheridge,3,2,1
669385277,Steve Towler,386517733,Ady Halley,3,3,0
669385277,Steve Towler,402257815,Jim Cumming,3,2,1
669385277,Steve Towler,971308746,Clive Harman,3,2,1
670034050,John Muzio,182,Brian Welfare,3,3,0
670034050,John Muzio,306438070,Martin Stocker,3,2,1
670034050,John Muzio,382970973,Paul Shaw,3,2,1
670034050,John Muzio,392533233,Jack Wright,3,3,0
670034050,John Muzio,490170224,Jamie Matthews,3,2,1
670034050,John Muzio,598846718,Ben Sorrell,3,3,0
670034050,John Muzio,736672590,Dean Perry,3,2,1
670034050,John Muzio,858283721,Dave Dunstall,3,2,1
670256222,Connor Anderson,174,Brian Grant,3,3,0
670256222,Connor Anderson,5820499,Paul Bartlett,3,3,0
670256222,Connor Anderson,144293731,Simon Parry,3,2,1
670256222,Connor Anderson,341869673,Nigel Stilwell,3,3,0
670256222,Connor Anderson,384960657,Dave Lewney,3,2,1
670256222,Connor Anderson,617751649,Lee Simpson,3,2,1
670256222,Connor Anderson,809568302,Mark Johnson,3,3,0
670256222,Connor Anderson,948504778,Jon Fordham,3,3,0
670256222,Connor Anderson,954297832,Pav Sareen,3,3,0
670870044,David Flanagan,271464632,Paul Phillips,3,3,0
670870044,David Flanagan,880982797,Ray Hunter,3,3,0
676753614,Don James,41461520,Luke Pooley,3,3,0
676753614,Don James,479705187,Keith McQueen,3,3,0
677110925,Jake Dunstall,278,Dave Fairbairn,3,2,1
677110925,Jake Dunstall,833156731,Jez Saunders,3,2,1
688252012,Sean Cooper,28382047,Steve Harrington,3,2,1
688252012,Sean Cooper,394906196,Mick Mabbitt,3,2,1
688252012,Sean Cooper,444350794,Richard Freeman,3,2,1
688252012,Sean Cooper,501266206,David Fox,3,2,1
688252012,Sean Cooper,880982797,Ray Hunter,3,3,0
688252012,Sean Cooper,970786910,Kevin Sorrell,3,2,1
688252012,Sean Cooper,978156264,Bob Paine,3,2,1
688778183,Dean Paice,32061370,Toby Prince-Iles,3,2,1
688778183,Dean Paice,35191252,Nigel Hayward,3,3,0
688778183,Dean Paice,216787426,Jack Perrin,3,2,1
688778183,Dean Paice,223983583,Carl Wentworth,3,3,0
688778183,Dean Paice,271464632,Paul Phillips,3,2,1
688778183,Dean Paice,279543944,Peter Maurice,3,2,1
688778183,Dean Paice,567624732,Dave Brampton,3,3,0
688778183,Dean Paice,719124015,Tony Power,3,3,0
688778183,Dean Paice,724342701,Nigel Lilley,3,3,0
688778183,Dean Paice,835713833,Olly Stewart,3,2,1
688778183,Dean Paice,852327692,Andy Fletcher,3,3,0
688778183,Dean Paice,971308746,Clive Harman,3,3,0
704007508,Alan Muir,27255501,Tom Lane,3,3,0
704007508,Alan Muir,293577764,Dave Crosskey,3,2,1
704007508,Alan Muir,688252012,Sean Cooper,3,3,0
704007508,Alan Muir,724342701,Nigel Lilley,3,3,0
704007508,Alan Muir,910809545,Blake Harman,3,3,0
713064363,John Trory,392533233,Jack Wright,3,2,1
717256135,Trevor Pickard,171346729,Des Heasman,3,3,0
717256135,Trevor Pickard,704007508,Alan Muir,3,3,0
717256135,Trevor Pickard,949603489,Pete Bennett,3,2,1
719124015,Tony Power,202090738,Alan Head,3,2,1
719124015,Tony Power,529382351,Greg Foat,3,3,0
719124015,Tony Power,721321839,Matt Peake,3,2,1
721321839,Matt Peake,124523642,Tom Hayes,3,2,1
724342701,Nigel Lilley,27255501,Tom Lane,3,3,0
724342701,Nigel Lilley,223983583,Carl Wentworth,3,2,1
728690686,Rick Rothschild,845758589,Charlie James,3,2,1
732321233,Nathan Brooks,412256116,Andy Sutton,3,2,1
732321233,Nathan Brooks,809568302,Mark Johnson,3,2,1
732415457,Barry Hall,181,Dave Roughley,3,2,1
732415457,Barry Hall,114319292,Oliver Gorrod,3,3,0
732415457,Barry Hall,567316488,Lee Millyard,3,3,0
732415457,Barry Hall,737709582,Tony Browne,3,2,1
732415457,Barry Hall,800114325,Roger Whiteley,3,2,1
732415457,Barry Hall,805165161,Steve Owen,3,2,1
732415457,Barry Hall,809647573,John Taylor,3,3,0
733453947,Phil Canham,124,Dave Tristram,3,2,1
733453947,Phil Canham,202090738,Alan Head,3,2,1
733453947,Phil Canham,225850882,John McLellan,3,2,1
733453947,Phil Canham,275738778,John Da Silva,3,2,1
737709582,Tony Browne,757827662,Clive Freestone,3,2,1
737709582,Tony Browne,807603289,Kevin Gardner,3,2,1
745152759,Kevin Jewell,41461520,Luke Pooley,3,2,1
745152759,Kevin Jewell,293577764,Dave Crosskey,3,2,1
746406369,Loz O'Keefe,56252722,Dave Pither,3,3,0
746406369,Loz O'Keefe,392533233,Jack Wright,3,2,1
746406369,Loz O'Keefe,732415457,Barry Hall,3,2,1
748064029,Paul Hughes,26970170,Kai Michael,3,2,1
752709358,Chris Mason,619390728,Steve Stylianou,3,2,1
752709358,Chris Mason,732321233,Nathan Brooks,3,3,0
752709358,Chris Mason,825399596,Pat Adams,3,3,0
752709358,Chris Mason,948504778,Jon Fordham,3,3,0
754250007,Freddie Blunden,3,Neal Gozzett,3,3,0
754250007,Freddie Blunden,384960657,Dave Lewney,3,2,1
754250007,Freddie Blunden,523395206,Jamie Lashmar,3,2,1
754250007,Freddie Blunden,797313851,Dave Anderson,3,3,0
757827662,Clive Freestone,160950731,Locky McCurdy,3,2,1
766684900,John Gillard,60575249,Ash Thurmer,3,3,0
766684900,John Gillard,384960657,Dave Lewney,3,3,0
766684900,John Gillard,506581042,Glen Dartnell,3,2,1
766684900,John Gillard,523395206,Jamie Lashmar,3,2,1
766684900,John Gillard,619390728,Steve Stylianou,3,2,1
766684900,John Gillard,754250007,Freddie Blunden,3,2,1
766684900,John Gillard,947143243,Chris Davis,3,2,1
773216781,Sean Payne,60575249,Ash Thurmer,3,3,0
773216781,Sean Payne,174147986,Lee Cliff,3,3,0
773216781,Sean Payne,567316488,Lee Millyard,3,3,0
773216781,Sean Payne,800114325,Roger Whiteley,3,2,1
773216781,Sean Payne,974385564,Danny Booker,3,2,1
788605510,Mark Rose,32061370,Toby Prince-Iles,3,3,0
788605510,Mark Rose,124523642,Tom Hayes,3,2,1
788605510,Mark Rose,402257815,Jim Cumming,3,3,0
794630189,Mark Coles,60575249,Ash Thurmer,3,3,0
794630189,Mark Coles,323907964,Russ Hughes,3,2,1
794630189,Mark Coles,809568302,Mark Johnson,3,3,0
797962517,Dave Lewis,426009127,Bav Patel,3,2,1
797962517,Dave Lewis,732321233,Nathan Brooks,3,2,1
797962517,Dave Lewis,948504778,Jon Fordham,3,2,1
800114325,Roger Whiteley,236,Lee Garland,3,3,0
800114325,Roger Whiteley,124523642,Tom Hayes,3,2,1
800114325,Roger Whiteley,463709832,Danny Wong,3,2,1
800114325,Roger Whiteley,529382351,Greg Foat,3,3,0
800114325,Roger Whiteley,670256222,Connor Anderson,3,2,1
800114325,Roger Whiteley,688778183,Dean Paice,3,2,1
800114325,Roger Whiteley,809647573,John Taylor,3,2,1
800114325,Roger Whiteley,848997254,Tom Parker,3,2,1
800114325,Roger Whiteley,963206772,Dean Moore,3,2,1
802242736,Steve Hughes,506581042,Glen Dartnell,3,2,1
802242736,Steve Hughes,717256135,Trevor Pickard,3,2,1
802242736,Steve Hughes,837429850,Paul Beecham,3,3,0
804381932,Ryan Harman,294944526,Rob Teanby,3,2,1
804381932,Ryan Harman,417786644,Eddie Collins,3,3,0
804381932,Ryan Harman,978156264,Bob Paine,3,2,1
805165161,Steve Owen,486,"Jim, Jr. Stevens",3,2,1
809568302,Mark Johnson,16,Mick Beck,3,3,0
809568302,Mark Johnson,136,Dave Bonwick,3,2,1
809568302,Mark Johnson,5820499,Paul Bartlett,3,3,0
809568302,Mark Johnson,60575249,Ash Thurmer,3,2,1
809568302,Mark Johnson,192463126,Gerry Lindsey,3,3,0
809568302,Mark Johnson,231975313,Danny English,3,2,1
809568302,Mark Johnson,390364577,Mark Bright,3,2,1
809568302,Mark Johnson,654650203,Alan O'Sullivan,3,3,0
809788967,Brett Williams,506581042,Glen Dartnell,3,2,1
809984729,Neil Scutt,490170224,Jamie Matthews,3,2,1
809984729,Neil Scutt,535728699,Fred Cooper,3,2,1
809984729,Neil Scutt,713064363,John Trory,3,2,1
815023707,David Senior,291198629,Tony Burt,3,2,1
815023707,David Senior,688252012,Sean Cooper,3,3,0
815023707,David Senior,943667183,John Stone,3,2,1
820231590,Alan Rook,239,Mick Lucas,3,2,1
820231590,Alan Rook,32061370,Toby Prince-Iles,3,3,0
820231590,Alan Rook,172646809,Robin Powell,3,3,0
820231590,Alan Rook,501266206,David Fox,3,2,1
820231590,Alan Rook,880982797,Ray Hunter,3,2,1
820231590,Alan Rook,943667183,John Stone,3,2,1
820231590,Alan Rook,978156264,Bob Paine,3,2,1
822983250,Alasdair Pratt,41098823,Mikey Booker,3,3,0
822983250,Alasdair Pratt,929636592,Danny Wilson,3,2,1
831214643,Tony Shipley,65,Paul Hudson,3,3,0
831214643,Tony Shipley,235,Derek Conley,3,2,1
831214643,Tony Shipley,172646809,Robin Powell,3,3,0
831214643,Tony Shipley,223983583,Carl Wentworth,3,3,0
831214643,Tony Shipley,661923191,Steve Gardner,3,2,1
831214643,Tony Shipley,845758589,Charlie James,3,2,1
833156731,Jez Saunders,287057630,Darren Hearn,3,3,0
833156731,Jez Saunders,417786644,Eddie Collins,3,2,1
835713833,Olly Stewart,120138229,Adam Butler,3,2,1
835713833,Olly Stewart,144776055,Brian Wilkes,3,3,0
835713833,Olly Stewart,171346729,Des Heasman,3,2,1
835713833,Olly Stewart,174147986,Lee Cliff,3,2,1
835713833,Olly Stewart,719124015,Tony Power,3,2,1
835713833,Olly Stewart,724342701,Nigel Lilley,3,3,0
835713833,Olly Stewart,737709582,Tony Browne,3,3,0
835713833,Olly Stewart,845758589,Charlie James,3,3,0
835713833,Olly Stewart,866506631,Mark Smith,3,2,1
836895047,Ian McKay,88,Steve Collins,3,2,1
836895047,Ian McKay,394,Alan Burchell,3,2,1
836895047,Ian McKay,83590771,Nick Brayne,3,2,1
836895047,Ian McKay,202090738,Alan Head,3,2,1
836895047,Ian McKay,225247539,Barry Knight,3,2,1
836895047,Ian McKay,231445676,Tony Paice,3,3,0
836895047,Ian McKay,654650203,Alan O'Sullivan,3,2,1
836895047,Ian McKay,688778183,Dean Paice,3,2,1
836895047,Ian McKay,736672590,Dean Perry,3,3,0
836895047,Ian McKay,910809545,Blake Harman,3,2,1
837429850,Paul Beecham,717256135,Trevor Pickard,3,3,0
843981340,Mark Glover,535728699,Fred Cooper,3,2,1
844676925,Kieran Williams,102,Reece Childs,3,2,1
844676925,Kieran Williams,394906196,Mick Mabbitt,3,2,1
844676925,Kieran Williams,401846353,Frank McHugh,3,2,1
844676925,Kieran Williams,899206834,Jez Downs,3,3,0
844676925,Kieran Williams,954080507,Sam Corsby,3,2,1
845537273,Dave Gridley,501266206,David Fox,3,2,1
845758589,Charlie James,149,Tony Nealgrove,3,2,1
845758589,Charlie James,164,Neil Bushell,3,3,0
845758589,Charlie James,172646809,Robin Powell,3,3,0
845758589,Charlie James,844676925,Kieran Williams,3,2,1
845758589,Charlie James,953512654,Les Berry,3,3,0
848997254,Tom Parker,124523642,Tom Hayes,3,2,1
848997254,Tom Parker,463709832,Danny Wong,3,2,1
848997254,Tom Parker,719124015,Tony Power,3,2,1
858283721,Dave Dunstall,98,Tony Collins,3,3,0
858283721,Dave Dunstall,70159035,Peter Rea,3,2,1
858283721,Dave Dunstall,275738778,John Da Silva,3,2,1
858283721,Dave Dunstall,293577764,Dave Crosskey,3,3,0
858283721,Dave Dunstall,386517733,Ady Halley,3,2,1
858283721,Dave Dunstall,529382351,Greg Foat,3,2,1
858283721,Dave Dunstall,820231590,Alan Rook,3,3,0
865803068,Dave Jones,278731588,Lester Grice,3,3,0
865803068,Dave Jones,948504778,Jon Fordham,3,3,0
865803068,Dave Jones,957784480,Harry Banks,3,2,1
866506631,Mark Smith,3508579,John Murray,3,3,0
866506631,Mark Smith,144776055,Brian Wilkes,3,3,0
866506631,Mark Smith,171346729,Des Heasman,3,2,1
866506631,Mark Smith,498330760,Mo Collins,3,3,0
866506631,Mark Smith,733453947,Phil Canham,3,3,0
867613624,Ian Dunhill,56252722,Dave Pither,3,2,1
867613624,Ian Dunhill,144776055,Brian Wilkes,3,2,1
867613624,Ian Dunhill,174147986,Lee Cliff,3,2,1
867613624,Ian Dunhill,291198629,Tony Burt,3,3,0
867613624,Ian Dunhill,430890681,Malcolm Cooper,3,2,1
867613624,Ian Dunhill,501266206,David Fox,3,3,0
867613624,Ian Dunhill,613893140,Matt Warner,3,2,1
867613624,Ian Dunhill,809647573,John Taylor,3,2,1
867613624,Ian Dunhill,809984729,Neil Scutt,3,2,1
867613624,Ian Dunhill,820231590,Alan Rook,3,3,0
873916947,Geoff Akehurst,402257815,Jim Cumming,3,2,1
873916947,Geoff Akehurst,537640521,Ian Stoner,3,2,1
876526526,Ash Bull,748064029,Paul Hughes,3,2,1
876526526,Ash Bull,754250007,Freddie Blunden,3,2,1
876526526,Ash Bull,802242736,Steve Hughes,3,3,0
878576746,Jon Hall,488,Roger Harrold,3,2,1
878576746,Jon Hall,949603489,Pete Bennett,3,2,1
880982797,Ray Hunter,529382351,Greg Foat,3,3,0
880982797,Ray Hunter,719124015,Tony Power,3,2,1
884365412,Dave Haslam,351143642,Michael Palmer,3,3,0
884374645,Wayne Iddon,936624299,Peter Gallant,3,3,0
889234854,Paul Smith,382970973,Paul Shaw,3,2,1
889234854,Paul Smith,417786644,Eddie Collins,3,3,0
889234854,Paul Smith,480154054,Jim Dunstall,3,2,1
889234854,Paul Smith,574248035,Tony Mulhern,3,2,1
889234854,Paul Smith,833156731,Jez Saunders,3,2,1
899206834,Jez Downs,183,Simon Alexander,3,2,1
899206834,Jez Downs,202,Bob Firth,3,2,1
899206834,Jez Downs,114319292,Oliver Gorrod,3,2,1
899206834,Jez Downs,287057630,Darren Hearn,3,3,0
899206834,Jez Downs,464085958,Gerwyn Bowen,3,2,1
899206834,Jez Downs,535728699,Fred Cooper,3,2,1
910809545,Blake Harman,574248035,Tony Mulhern,3,2,1
910809545,Blake Harman,733453947,Phil Canham,3,3,0
910809545,Blake Harman,820231590,Alan Rook,3,2,1
910809545,Blake Harman,966905561,Tony Dade,3,2,1
915035871,Kevin Graysmark,444350794,Richard Freeman,3,2,1
927588200,Tokki Yamaguchi,231975313,Danny English,3,2,1
929636592,Danny Wilson,327,Harold Franks,3,3,0
929636592,Danny Wilson,567316488,Lee Millyard,3,2,1
936624299,Peter Gallant,293577764,Dave Crosskey,3,2,1
936624299,Peter Gallant,402257815,Jim Cumming,3,2,1
936624299,Peter Gallant,745152759,Kevin Jewell,3,3,0
943667183,John Stone,401846353,Frank McHugh,3,2,1
947143243,Chris Davis,278731588,Lester Grice,3,2,1
947143243,Chris Davis,797962517,Dave Lewis,3,2,1
947143243,Chris Davis,948504778,Jon Fordham,3,2,1
947620111,Neil Cutler,279543944,Peter Maurice,3,2,1
948504778,Jon Fordham,825399596,Pat Adams,3,2,1
951468676,Steve Burchett,275738778,John Da Silva,3,2,1
951468676,Steve Burchett,291816585,Jim Somers,3,3,0
951468676,Steve Burchett,733453947,Phil Canham,3,2,1
954080507,Sam Corsby,721321839,Matt Peake,3,2,1
954080507,Sam Corsby,878576746,Jon Hall,3,2,1
954080507,Sam Corsby,949603489,Pete Bennett,3,2,1
954297832,Pav Sareen,428102632,Anthony Flynn,3,2,1
954639632,Derek Budde,38,Rob Bowden,3,3,0
954639632,Derek Budde,510918620,Robert Bowden,3,3,0
954639632,Derek Budde,535728699,Fred Cooper,3,3,0
954639632,Derek Budde,873916947,Geoff Akehurst,3,3,0
957784480,Harry Banks,70,Michael Turner-Lee,3,2,1
957784480,Harry Banks,26970170,Kai Michael,3,2,1
957784480,Harry Banks,307140835,Tony Strange,3,2,1
957784480,Harry Banks,506581042,Glen Dartnell,3,2,1
957784480,Harry Banks,600385553,Darren Welfare,3,2,1
957784480,Harry Banks,717256135,Trevor Pickard,3,2,1
957784480,Harry Banks,802242736,Steve Hughes,3,2,1
957784480,Harry Banks,809568302,Mark Johnson,3,2,1
957784480,Harry Banks,884365412,Dave Haslam,3,3,0
963206772,Dean Moore,98,Tony Collins,3,3,0
963206772,Dean Moore,171346729,Des Heasman,3,2,1
963206772,Dean Moore,670034050,John Muzio,3,3,0
963206772,Dean Moore,677110925,Jake Dunstall,3,2,1
963206772,Dean Moore,880982797,Ray Hunter,3,2,1
966905561,Tony Dade,80,Dave Wells,3,3,0
966905561,Tony Dade,745152759,Kevin Jewell,3,3,0
968651401,Ryan Grover,579164381,Danny Cattell,3,2,1
970786910,Kevin Sorrell,32061370,Toby Prince-Iles,3,3,0
970786910,Kevin Sorrell,430890681,Malcolm Cooper,3,3,0
970786910,Kevin Sorrell,719124015,Tony Power,3,2,1
970786910,Kevin Sorrell,899206834,Jez Downs,3,3,0
971308746,Clive Harman,183,Simon Alexander,3,3,0
971308746,Clive Harman,3508579,John Murray,3,2,1
971308746,Clive Harman,41461520,Luke Pooley,3,3,0
971308746,Clive Harman,172646809,Robin Powell,3,3,0
971308746,Clive Harman,745152759,Kevin Jewell,3,3,0
971308746,Clive Harman,873916947,Geoff Akehurst,3,2,1
971308746,Clive Harman,943667183,John Stone,3,3,0
974385564,Danny Booker,76,David Rea,3,2,1
974385564,Danny Booker,173,Dave Alderton,3,2,1
974385564,Danny Booker,118679261,Mick Lott,3,2,1
974385564,Danny Booker,124523642,Tom Hayes,3,3,0
974385564,Danny Booker,174147986,Lee Cliff,3,2,1
974385564,Danny Booker,275738778,John Da Silva,3,2,1
974385564,Danny Booker,436708540,Bob Henley,3,2,1
974385564,Danny Booker,444350794,Richard Freeman,3,3,0
974385564,Danny Booker,455401154,Kai Ellis,3,2,1
974385564,Danny Booker,598846718,Ben Sorrell,3,3,0
974385564,Danny Booker,717256135,Trevor Pickard,3,3,0
974385564,Danny Booker,848997254,Tom Parker,3,2,1
974385564,Danny Booker,873916947,Geoff Akehurst,3,3,0
974385564,Danny Booker,884365412,Dave Haslam,3,3,0
978156264,Bob Paine,943667183,John Stone,3,2,1
1,Tim Dawes,837429850,Paul Beecham,2,1,1
1,Tim Dawes,963958265,Rodney Moogan,2,1,1
3,Neal Gozzett,59858690,James Constable,2,2,0
3,Neal Gozzett,837429850,Paul Beecham,2,2,0
5,Paul Osiecki,133,Darren Bradley,2,2,0
5,Paul Osiecki,837429850,Paul Beecham,2,2,0
6,Dan Stirling,9,Michael Cheung,2,2,0
6,Dan Stirling,16,Mick Beck,2,1,1
6,Dan Stirling,90176364,David Page,2,2,0
6,Dan Stirling,112887737,Pip Akehurst,2,2,0
6,Dan Stirling,600385553,Darren Welfare,2,1,1
6,Dan Stirling,666735933,Mike Collier,2,1,1
6,Dan Stirling,748064029,Paul Hughes,2,1,1
6,Dan Stirling,957784480,Harry Banks,2,1,1
8,Colin Barber,192463126,Gerry Lindsey,2,2,0
9,Michael Cheung,17,Tony Funnell,2,1,1
9,Michael Cheung,393,Mark Purser,2,1,1
9,Michael Cheung,60575249,Ash Thurmer,2,2,0
14,Michael West,3,Neal Gozzett,2,2,0
14,Michael West,222,John Newnhan,2,2,0
14,Michael West,90176364,David Page,2,2,0
14,Michael West,345558874,Zack Richardson,2,2,0
14,Michael West,748064029,Paul Hughes,2,1,1
14,Michael West,766684900,John Gillard,2,1,1
16,Mick Beck,326,Stefan Chandler,2,2,0
16,Mick Beck,5820499,Paul Bartlett,2,2,0
16,Mick Beck,266591683,Chris Roche,2,2,0
16,Mick Beck,279543944,Peter Maurice,2,2,0
16,Mick Beck,567316488,Lee Millyard,2,2,0
16,Mick Beck,810143915,Ben Welfare,2,2,0
19,Andros Harilaou,137,Ricky Beecham,2,1,1
19,Andros Harilaou,600385553,Darren Welfare,2,1,1
22,Tim Shutt,608140548,David Gillingham,2,1,1
22,Tim Shutt,963958265,Rodney Moogan,2,1,1
28,Simon Parker,231975313,Danny English,2,1,1
31,Gary Dartnell,149,Tony Nealgrove,2,2,0
31,Gary Dartnell,183,Simon Alexander,2,1,1
31,Gary Dartnell,866506631,Mark Smith,2,1,1
31,Gary Dartnell,899206834,Jez Downs,2,1,1
37,Kieran Tighe,83,Eric Gumbrell,2,2,0
37,Kieran Tighe,180,Pat Sweeney,2,1,1
37,Kieran Tighe,199,Mark Holloway,2,2,0
38,Rob Bowden,202,Bob Firth,2,2,0
38,Rob Bowden,288,Pete Elliott,2,2,0
38,Rob Bowden,573567936,Steve Marriott,2,2,0
38,Rob Bowden,612265840,Paul Honeysett,2,1,1
38,Rob Bowden,670034050,John Muzio,2,1,1
39,Steve Goldthorpe,84,Gavin McCubbin,2,2,0
40,Shykul Malique,316,Paul Redgate,2,2,0
40,Shykul Malique,873916947,Geoff Akehurst,2,1,1
44,John McGuigan,248,R. Teagle,2,1,1
44,John McGuigan,275738778,John Da Silva,2,1,1
49,Daniel James,84,Gavin McCubbin,2,2,0
49,Daniel James,102,Reece Childs,2,1,1
49,Daniel James,281,Bob Rumble,2,1,1
49,Daniel James,288,Pete Elliott,2,2,0
49,Daniel James,815023707,David Senior,2,2,0
61,Paul Gander,70,Michael Turner-Lee,2,1,1
61,Paul Gander,235,Derek Conley,2,2,0
61,Paul Gander,172646809,Robin Powell,2,2,0
61,Paul Gander,278731588,Lester Grice,2,1,1
61,Paul Gander,608140548,David Gillingham,2,1,1
61,Paul Gander,880982797,Ray Hunter,2,1,1
63,Colin Penson,116,Ken Mason,2,2,0
63,Colin Penson,193,Gary Goodman,2,2,0
63,Colin Penson,315,Peter Stevens,2,1,1
63,Colin Penson,231445676,Tony Paice,2,2,0
63,Colin Penson,503528426,Larry Maloney,2,1,1
65,Paul Hudson,115,Jim Collins,2,2,0
65,Paul Hudson,463709832,Danny Wong,2,1,1
65,Paul Hudson,529382351,Greg Foat,2,2,0
65,Paul Hudson,734416600,DON PENALVER,2,1,1
65,Paul Hudson,850059806,Heng Wong,2,1,1
70,Michael Turner-Lee,117,Joe Collins,2,1,1
70,Michael Turner-Lee,90176364,David Page,2,1,1
70,Michael Turner-Lee,231445676,Tony Paice,2,1,1
75,Chris Rea,174147986,Lee Cliff,2,1,1
76,David Rea,108,John Wooller,2,1,1
76,David Rea,110039677,Mick Miller,2,1,1
76,David Rea,172646809,Robin Powell,2,1,1
76,David Rea,423038309,Ian Fennell,2,2,0
76,David Rea,537640521,Ian Stoner,2,2,0
78,Kevin Baker,300,Graham Smart,2,1,1
78,Kevin Baker,110039677,Mick Miller,2,1,1
78,Kevin Baker,436708540,Bob Henley,2,1,1
78,Kevin Baker,579164381,Danny Cattell,2,1,1
80,Dave Wells,447,Barry Riddles,2,1,1
80,Dave Wells,56252722,Dave Pither,2,1,1
80,Dave Wells,101751030,Simon Uddin,2,2,0
80,Dave Wells,943667183,John Stone,2,2,0
81,Nick Bollingbroke,411473516,Ray Canham,2,2,0
82,Gavin Williams,188,Phil Turner,2,1,1
83,Eric Gumbrell,202,Bob Firth,2,1,1
83,Eric Gumbrell,889234854,Paul Smith,2,1,1
84,Gavin McCubbin,102,Reece Childs,2,1,1
84,Gavin McCubbin,284,Ray Bradley,2,1,1
84,Gavin McCubbin,384,Bryan Beck,2,1,1
84,Gavin McCubbin,442,Harvey Tuck,2,1,1
84,Gavin McCubbin,401846353,Frank McHugh,2,2,0
84,Gavin McCubbin,498330760,Mo Collins,2,2,0
84,Gavin McCubbin,535728699,Fred Cooper,2,1,1
84,Gavin McCubbin,688252012,Sean Cooper,2,2,0
84,Gavin McCubbin,910809545,Blake Harman,2,1,1
84,Gavin McCubbin,936624299,Peter Gallant,2,1,1
88,Steve Collins,114184042,Ian Smith,2,2,0
88,Steve Collins,202090738,Alan Head,2,1,1
88,Steve Collins,231445676,Tony Paice,2,1,1
88,Steve Collins,719124015,Tony Power,2,1,1
89,Mike Atkins,16,Mick Beck,2,2,0
89,Mike Atkins,279543944,Peter Maurice,2,1,1
89,Mike Atkins,323907964,Russ Hughes,2,1,1
89,Mike Atkins,567316488,Lee Millyard,2,2,0
89,Mike Atkins,688778183,Dean Paice,2,2,0
89,Mike Atkins,948504778,Jon Fordham,2,2,0
92,Dale Thomas,649240057,Mike Childs,2,1,1
92,Dale Thomas,954639632,Derek Budde,2,1,1
93,Derek Hazelgrove,281,Bob Rumble,2,1,1
94,Don McCreery,39289507,Mick Laughlin,2,1,1
96,Dave Kellett,101,Jason Childs,2,2,0
96,Dave Kellett,28382047,Steve Harrington,2,2,0
96,Dave Kellett,39289507,Mick Laughlin,2,1,1
96,Dave Kellett,229719541,Scott Manning,2,1,1
96,Dave Kellett,394906196,Mick Mabbitt,2,2,0
96,Dave Kellett,537640521,Ian Stoner,2,2,0
96,Dave Kellett,613893140,Matt Warner,2,1,1
96,Dave Kellett,728690686,Rick Rothschild,2,2,0
96,Dave Kellett,936624299,Peter Gallant,2,2,0
97,Shaun Winsor,102,Reece Childs,2,1,1
97,Shaun Winsor,182,Brian Welfare,2,2,0
97,Shaun Winsor,428,Mike Fletcher,2,2,0
97,Shaun Winsor,160950731,Locky McCurdy,2,1,1
97,Shaun Winsor,223983583,Carl Wentworth,2,2,0
97,Shaun Winsor,613893140,Matt Warner,2,1,1
97,Shaun Winsor,676753614,Don James,2,1,1
97,Shaun Winsor,936624299,Peter Gallant,2,2,0
97,Shaun Winsor,966905561,Tony Dade,2,1,1
98,Tony Collins,149,Tony Nealgrove,2,2,0
98,Tony Collins,239,Mick Lucas,2,1,1
98,Tony Collins,381,Aaron Jones,2,2,0
98,Tony Collins,101751030,Simon Uddin,2,2,0
98,Tony Collins,410854609,Dave Lowe,2,2,0
98,Tony Collins,417786644,Eddie Collins,2,1,1
98,Tony Collins,479705187,Keith McQueen,2,2,0
98,Tony Collins,613893140,Matt Warner,2,1,1
98,Tony Collins,978156264,Bob Paine,2,2,0
101,Jason Childs,291,John Taylor,2,1,1
102,Reece Childs,284,Ray Bradley,2,2,0
102,Reece Childs,286,Paul Baker,2,1,1
102,Reece Childs,386,Sam Hains,2,1,1
102,Reece Childs,445,Lachlan Monroe,2,2,0
102,Reece Childs,160950731,Locky McCurdy,2,1,1
102,Reece Childs,266477517,Tony Baxter,2,2,0
102,Reece Childs,401846353,Frank McHugh,2,2,0
102,Reece Childs,479705187,Keith McQueen,2,2,0
108,John Wooller,193,Gary Goodman,2,1,1
108,John Wooller,235,Derek Conley,2,2,0
108,John Wooller,529382351,Greg Foat,2,1,1
108,John Wooller,608140548,David Gillingham,2,1,1
108,John Wooller,880982797,Ray Hunter,2,1,1
115,Jim Collins,831214643,Tony Shipley,2,1,1
115,Jim Collins,850059806,Heng Wong,2,1,1
117,Joe Collins,60575249,Ash Thurmer,2,1,1
117,Joe Collins,279543944,Peter Maurice,2,2,0
117,Joe Collins,947620111,Neil Cutler,2,1,1
121,Mike Barnett,173,Dave Alderton,2,1,1
121,Mike Barnett,321,Mick Ingram,2,1,1
121,Mike Barnett,504,Aaron Immerson,2,1,1
121,Mike Barnett,411473516,Ray Canham,2,1,1
121,Mike Barnett,574248035,Tony Mulhern,2,1,1
121,Mike Barnett,732321233,Nathan Brooks,2,1,1
121,Mike Barnett,971308746,Clive Harman,2,2,0
124,Dave Tristram,297,S. Grogan,2,1,1
124,Dave Tristram,327948141,Ross Etheridge,2,1,1
124,Dave Tristram,411473516,Ray Canham,2,1,1
124,Dave Tristram,451309825,Maurice Wickens,2,1,1
124,Dave Tristram,455401154,Kai Ellis,2,1,1
127,Dave Turner,282,Adam Harrild,2,1,1
127,Dave Turner,266477517,Tony Baxter,2,1,1
133,Darren Bradley,802242736,Steve Hughes,2,1,1
136,Dave Bonwick,365,Dan Buckwell,2,1,1
136,Dave Bonwick,384960657,Dave Lewney,2,1,1
136,Dave Bonwick,963958265,Rodney Moogan,2,1,1
138,Jack McCulloch,182,Brian Welfare,2,2,0
147,K. Patmore,464085958,Gerwyn Bowen,2,1,1
149,Tony Nealgrove,429738563,Adam Buckingham,2,1,1
149,Tony Nealgrove,546362444,Anthony Trory,2,1,1
149,Tony Nealgrove,858283721,Dave Dunstall,2,1,1
153,Tony Leach,364867274,Dave Lucking,2,1,1
157,Stewart Swanton,175,Dudley Rignall,2,1,1
157,Stewart Swanton,436708540,Bob Henley,2,1,1
164,Neil Bushell,239,Mick Lucas,2,2,0
171,Darren Bell,59858690,James Constable,2,1,1
171,Darren Bell,384960657,Dave Lewney,2,2,0
173,Dave Alderton,138,Jack McCulloch,2,2,0
173,Dave Alderton,295,Graham Still,2,2,0
173,Dave Alderton,319,John Lojo,2,1,1
173,Dave Alderton,479,Brian Welsh,2,1,1
173,Dave Alderton,26970170,Kai Michael,2,1,1
173,Dave Alderton,110039677,Mick Miller,2,2,0
173,Dave Alderton,225850882,John McLellan,2,2,0
173,Dave Alderton,291816585,Jim Somers,2,1,1
173,Dave Alderton,412256116,Andy Sutton,2,2,0
173,Dave Alderton,736672590,Dean Perry,2,1,1
173,Dave Alderton,809647573,John Taylor,2,1,1
173,Dave Alderton,878576746,Jon Hall,2,1,1
173,Dave Alderton,954080507,Sam Corsby,2,2,0
174,Brian Grant,123,Gary Burton,2,2,0
174,Brian Grant,297,S. Grogan,2,2,0
174,Brian Grant,301,Terry Grant,2,2,0
174,Brian Grant,174147986,Lee Cliff,2,1,1
174,Brian Grant,412256116,Andy Sutton,2,1,1
174,Brian Grant,444350794,Richard Freeman,2,2,0
174,Brian Grant,878576746,Jon Hall,2,1,1
174,Brian Grant,884365412,Dave Haslam,2,1,1
175,Dudley Rignall,319,John Lojo,2,1,1
175,Dudley Rignall,337,Adam Williams,2,2,0
175,Dudley Rignall,213264678,Martin Hall,2,1,1
177,John Regan,153,Tony Leach,2,2,0
177,John Regan,3508579,John Murray,2,1,1
177,John Regan,351143642,Michael Palmer,2,2,0
177,John Regan,436708540,Bob Henley,2,1,1
177,John Regan,506320151,Frank Taylor,2,1,1
177,John Regan,954080507,Sam Corsby,2,1,1
179,Mick Jones,98,Tony Collins,2,2,0
179,Mick Jones,670034050,John Muzio,2,1,1
180,Pat Sweeney,98,Tony Collins,2,2,0
180,Pat Sweeney,138,Jack McCulloch,2,2,0
180,Pat Sweeney,225247539,Barry Knight,2,2,0
180,Pat Sweeney,670034050,John Muzio,2,2,0
181,Dave Roughley,78,Kevin Baker,2,2,0
181,Dave Roughley,83,Eric Gumbrell,2,2,0
181,Dave Roughley,149,Tony Nealgrove,2,2,0
181,Dave Roughley,199,Mark Holloway,2,2,0
181,Dave Roughley,124523642,Tom Hayes,2,1,1
181,Dave Roughley,223983583,Carl Wentworth,2,1,1
181,Dave Roughley,275738778,John Da Silva,2,2,0
181,Dave Roughley,464085958,Gerwyn Bowen,2,2,0
181,Dave Roughley,537640521,Ian Stoner,2,2,0
181,Dave Roughley,670034050,John Muzio,2,1,1
181,Dave Roughley,889234854,Paul Smith,2,2,0
181,Dave Roughley,899206834,Jez Downs,2,2,0
182,Brian Welfare,307,Alister Morrison,2,1,1
182,Brian Welfare,41461520,Luke Pooley,2,1,1
182,Brian Welfare,225247539,Barry Knight,2,2,0
182,Brian Welfare,386517733,Ady Halley,2,2,0
182,Brian Welfare,537640521,Ian Stoner,2,1,1
182,Brian Welfare,598846718,Ben Sorrell,2,1,1
182,Brian Welfare,833156731,Jez Saunders,2,2,0
182,Brian Welfare,873916947,Geoff Akehurst,2,2,0
182,Brian Welfare,889234854,Paul Smith,2,1,1
183,Simon Alexander,202,Bob Firth,2,1,1
183,Simon Alexander,278,Dave Fairbairn,2,1,1
183,Simon Alexander,713064363,John Trory,2,1,1
183,Simon Alexander,866506631,Mark Smith,2,1,1
183,Simon Alexander,889234854,Paul Smith,2,1,1
188,Phil Turner,39,Steve Goldthorpe,2,2,0
188,Phil Turner,309,M. Humphries,2,1,1
188,Phil Turner,943667183,John Stone,2,2,0
190,Paul Mitchell,114184042,Ian Smith,2,1,1
193,Gary Goodman,236,Lee Garland,2,2,0
193,Gary Goodman,600385553,Darren Welfare,2,1,1
193,Gary Goodman,688778183,Dean Paice,2,2,0
193,Gary Goodman,957784480,Harry Banks,2,1,1
198,Chris Playford,116,Ken Mason,2,2,0
198,Chris Playford,754250007,Freddie Blunden,2,1,1
198,Chris Playford,831214643,Tony Shipley,2,1,1
199,Mark Holloway,278,Dave Fairbairn,2,1,1
199,Mark Holloway,307,Alister Morrison,2,1,1
199,Mark Holloway,866506631,Mark Smith,2,1,1
199,Mark Holloway,899206834,Jez Downs,2,2,0
199,Mark Holloway,911104566,Steve Linton,2,2,0
199,Mark Holloway,963206772,Dean Moore,2,1,1
202,Bob Firth,364867274,Dave Lucking,2,2,0
202,Bob Firth,386517733,Ady Halley,2,1,1
222,John Newnhan,323907964,Russ Hughes,2,1,1
222,John Newnhan,384960657,Dave Lewney,2,2,0
222,John Newnhan,600385553,Darren Welfare,2,1,1
222,John Newnhan,724342701,Nigel Lilley,2,1,1
222,John Newnhan,794630189,Mark Coles,2,1,1
235,Derek Conley,395,Herby Burchell,2,1,1
235,Derek Conley,26970170,Kai Michael,2,1,1
235,Derek Conley,90176364,David Page,2,1,1
235,Derek Conley,112887737,Pip Akehurst,2,1,1
235,Derek Conley,279543944,Peter Maurice,2,1,1
235,Derek Conley,724342701,Nigel Lilley,2,1,1
235,Derek Conley,734416600,DON PENALVER,2,1,1
236,Lee Garland,529382351,Greg Foat,2,2,0
236,Lee Garland,831214643,Tony Shipley,2,1,1
236,Lee Garland,836895047,Ian McKay,2,1,1
236,Lee Garland,880982797,Ray Hunter,2,2,0
237,Paul Wilson,61,Paul Gander,2,2,0
237,Paul Wilson,278731588,Lester Grice,2,1,1
237,Paul Wilson,279543944,Peter Maurice,2,1,1
237,Paul Wilson,800114325,Roger Whiteley,2,2,0
239,Mick Lucas,84,Gavin McCubbin,2,2,0
239,Mick Lucas,390,Luke Cann,2,1,1
239,Mick Lucas,516,Lee Fairclough,2,1,1
239,Mick Lucas,56252722,Dave Pither,2,1,1
244,Dave Burchett,411473516,Ray Canham,2,1,1
244,Dave Burchett,833156731,Jez Saunders,2,1,1
244,Dave Burchett,915035871,Kevin Graysmark,2,1,1
247,Mick Justice,84,Gavin McCubbin,2,2,0
247,Mick Justice,282,Adam Harrild,2,2,0
247,Mick Justice,442,Harvey Tuck,2,1,1
247,Mick Justice,39289507,Mick Laughlin,2,2,0
247,Mick Justice,101751030,Simon Uddin,2,2,0
247,Mick Justice,266477517,Tony Baxter,2,1,1
247,Mick Justice,417786644,Eddie Collins,2,1,1
247,Mick Justice,506581042,Glen Dartnell,2,1,1
247,Mick Justice,688252012,Sean Cooper,2,1,1
247,Mick Justice,815023707,David Senior,2,2,0
247,Mick Justice,873916947,Geoff Akehurst,2,1,1
248,R. Teagle,316,Paul Redgate,2,1,1
248,R. Teagle,845758589,Charlie James,2,1,1
272,Carlo Lupi,177,John Regan,2,2,0
272,Carlo Lupi,114184042,Ian Smith,2,1,1
272,Carlo Lupi,412256116,Andy Sutton,2,2,0
272,Carlo Lupi,661923191,Steve Gardner,2,2,0
275,Brian Balchin,340,A. Bartup,2,1,1
275,Brian Balchin,411473516,Ray Canham,2,1,1
275,Brian Balchin,936624299,Peter Gallant,2,1,1
278,Dave Fairbairn,188,Phil Turner,2,2,0
278,Dave Fairbairn,223983583,Carl Wentworth,2,1,1
278,Dave Fairbairn,386517733,Ady Halley,2,1,1
278,Dave Fairbairn,417786644,Eddie Collins,2,1,1
278,Dave Fairbairn,820231590,Alan Rook,2,2,0
278,Dave Fairbairn,889234854,Paul Smith,2,1,1
281,Bob Rumble,92,Dale Thomas,2,2,0
281,Bob Rumble,390,Luke Cann,2,1,1
281,Bob Rumble,266477517,Tony Baxter,2,1,1
282,Adam Harrild,316,Paul Redgate,2,2,0
282,Adam Harrild,415524562,Dave King,2,2,0
282,Adam Harrild,809984729,Neil Scutt,2,1,1
282,Adam Harrild,815023707,David Senior,2,2,0
284,Ray Bradley,28382047,Steve Harrington,2,1,1
285,Pete Davie,32061370,Toby Prince-Iles,2,2,0
285,Pete Davie,401846353,Frank McHugh,2,2,0
285,Pete Davie,498330760,Mo Collins,2,2,0
285,Pete Davie,820231590,Alan Rook,2,2,0
286,Paul Baker,746406369,Loz O'Keefe,2,1,1
286,Paul Baker,978156264,Bob Paine,2,1,1
287,Chris Johns,49,Daniel James,2,2,0
287,Chris Johns,266477517,Tony Baxter,2,2,0
287,Chris Johns,490170224,Jamie Matthews,2,2,0
287,Chris Johns,612265840,Paul Honeysett,2,1,1
287,Chris Johns,676753614,Don James,2,2,0
288,Pete Elliott,98,Tony Collins,2,2,0
288,Pete Elliott,149,Tony Nealgrove,2,2,0
288,Pete Elliott,286,Paul Baker,2,2,0
288,Pete Elliott,479705187,Keith McQueen,2,2,0
288,Pete Elliott,490170224,Jamie Matthews,2,1,1
288,Pete Elliott,612265840,Paul Honeysett,2,2,0
288,Pete Elliott,815023707,David Senior,2,1,1
288,Pete Elliott,845758589,Charlie James,2,1,1
291,John Taylor,92,Dale Thomas,2,2,0
292,Jim Mulcahey,573567936,Steve Marriott,2,1,1
294,Bob Tullett,392533233,Jack Wright,2,1,1
294,Bob Tullett,641692362,Bob Taylor,2,1,1
294,Bob Tullett,713064363,John Trory,2,2,0
295,Graham Still,138,Jack McCulloch,2,2,0
295,Graham Still,225850882,John McLellan,2,2,0
297,S. Grogan,878576746,Jon Hall,2,1,1
300,Graham Smart,901024459,Paul Charman,2,1,1
301,Terry Grant,26970170,Kai Michael,2,1,1
303,Graham Williard,26970170,Kai Michael,2,1,1
303,Graham Williard,225850882,John McLellan,2,2,0
303,Graham Williard,436708540,Bob Henley,2,1,1
307,Alister Morrison,16253983,Tony Simmonds,2,1,1
307,Alister Morrison,172899919,Derek Dale,2,2,0
307,Alister Morrison,733453947,Phil Canham,2,2,0
309,M. Humphries,833156731,Jez Saunders,2,2,0
315,Peter Stevens,121,Mike Barnett,2,2,0
315,Peter Stevens,182,Brian Welfare,2,2,0
315,Peter Stevens,321,Mick Ingram,2,2,0
315,Peter Stevens,395,Herby Burchell,2,2,0
315,Peter Stevens,110039677,Mick Miller,2,2,0
315,Peter Stevens,266591683,Chris Roche,2,1,1
315,Peter Stevens,364867274,Dave Lucking,2,1,1
315,Peter Stevens,529382351,Greg Foat,2,1,1
315,Peter Stevens,809647573,John Taylor,2,2,0
315,Peter Stevens,889234854,Paul Smith,2,2,0
316,Paul Redgate,309,M. Humphries,2,2,0
316,Paul Redgate,386,Sam Hains,2,2,0
316,Paul Redgate,390,Luke Cann,2,2,0
316,Paul Redgate,447,Barry Riddles,2,2,0
316,Paul Redgate,76011459,Kane Harman,2,1,1
316,Paul Redgate,293577764,Dave Crosskey,2,1,1
316,Paul Redgate,495939788,Tyrone Davis,2,2,0
316,Paul Redgate,688252012,Sean Cooper,2,1,1
316,Paul Redgate,815023707,David Senior,2,1,1
316,Paul Redgate,936624299,Peter Gallant,2,1,1
316,Paul Redgate,966905561,Tony Dade,2,2,0
319,John Lojo,301,Terry Grant,2,2,0
319,John Lojo,3508579,John Murray,2,1,1
319,John Lojo,423038309,Ian Fennell,2,1,1
319,John Lojo,506320151,Frank Taylor,2,1,1
319,John Lojo,574248035,Tony Mulhern,2,1,1
319,John Lojo,752709358,Chris Mason,2,1,1
319,John Lojo,878576746,Jon Hall,2,1,1
319,John Lojo,974385564,Danny Booker,2,1,1
321,Mick Ingram,110039677,Mick Miller,2,1,1
321,Mick Ingram,411473516,Ray Canham,2,1,1
326,Stefan Chandler,345558874,Zack Richardson,2,1,1
327,Harold Franks,285,Pete Davie,2,2,0
327,Harold Franks,286,Paul Baker,2,2,0
327,Harold Franks,498330760,Mo Collins,2,1,1
336,L. Fulton,412256116,Andy Sutton,2,1,1
336,L. Fulton,574248035,Tony Mulhern,2,2,0
337,Adam Williams,732321233,Nathan Brooks,2,2,0
337,Adam Williams,954080507,Sam Corsby,2,1,1
340,A. Bartup,84,Gavin McCubbin,2,2,0
356,Scott Harris,284,Ray Bradley,2,2,0
356,Scott Harris,160950731,Locky McCurdy,2,1,1
362,Gary Bottomly,810143915,Ben Welfare,2,2,0
365,Dan Buckwell,60575249,Ash Thurmer,2,2,0
365,Dan Buckwell,112887737,Pip Akehurst,2,1,1
365,Dan Buckwell,748064029,Paul Hughes,2,2,0
365,Dan Buckwell,963958265,Rodney Moogan,2,2,0
367,Chris Dolding,88,Steve Collins,2,2,0
367,Chris Dolding,394,Alan Burchell,2,2,0
367,Chris Dolding,231445676,Tony Paice,2,1,1
371,Laurence Park,292,Jim Mulcahey,2,2,0
371,Laurence Park,349269645,Barry Thornton,2,1,1
371,Laurence Park,392533233,Jack Wright,2,1,1
371,Laurence Park,417786644,Eddie Collins,2,2,0
371,Laurence Park,612265840,Paul Honeysett,2,2,0
371,Laurence Park,884374645,Wayne Iddon,2,1,1
371,Laurence Park,954639632,Derek Budde,2,1,1
374,Lloyd Saunders,396,Richard Dale,2,1,1
375,Paul Bailey,440,Gordon Carter,2,2,0
375,Paul Bailey,291816585,Jim Somers,2,2,0
375,Paul Bailey,392533233,Jack Wright,2,2,0
375,Paul Bailey,394906196,Mick Mabbitt,2,2,0
375,Paul Bailey,490170224,Jamie Matthews,2,2,0
375,Paul Bailey,713064363,John Trory,2,2,0
377,Gary Bradshaw,349269645,Barry Thornton,2,1,1
377,Gary Bradshaw,713064363,John Trory,2,2,0
377,Gary Bradshaw,845758589,Charlie James,2,1,1
378,Simon Howe,374,Lloyd Saunders,2,2,0
378,Simon Howe,319057545,Brendan Lambe,2,2,0
378,Simon Howe,394906196,Mick Mabbitt,2,1,1
378,Simon Howe,948504778,Jon Fordham,2,2,0
384,Bryan Beck,327,Harold Franks,2,2,0
384,Bryan Beck,417786644,Eddie Collins,2,1,1
384,Bryan Beck,501266206,David Fox,2,1,1
384,Bryan Beck,844676925,Kieran Williams,2,1,1
386,Sam Hains,28382047,Steve Harrington,2,1,1
386,Sam Hains,291816585,Jim Somers,2,2,0
386,Sam Hains,410854609,Dave Lowe,2,1,1
386,Sam Hains,966905561,Tony Dade,2,1,1
388,Jacob Stevenson,101751030,Simon Uddin,2,2,0
388,Jacob Stevenson,246154671,Alan Gunn,2,2,0
388,Jacob Stevenson,415524562,Dave King,2,1,1
388,Jacob Stevenson,746406369,Loz O'Keefe,2,2,0
390,Luke Cann,160950731,Locky McCurdy,2,1,1
392,Gareth Milburn,112887737,Pip Akehurst,2,2,0
392,Gareth Milburn,428102632,Anthony Flynn,2,1,1
394,Alan Burchell,231445676,Tony Paice,2,1,1
394,Alan Burchell,279543944,Peter Maurice,2,2,0
394,Alan Burchell,503528426,Larry Maloney,2,1,1
394,Alan Burchell,529382351,Greg Foat,2,2,0
394,Alan Burchell,661923191,Steve Gardner,2,1,1
395,Herby Burchell,503528426,Larry Maloney,2,1,1
395,Herby Burchell,719124015,Tony Power,2,1,1
395,Herby Burchell,810143915,Ben Welfare,2,1,1
395,Herby Burchell,947620111,Neil Cutler,2,1,1
399,Chris Upton,384,Bryan Beck,2,2,0
403,Joe Marcuson,943667183,John Stone,2,1,1
414,Richard Kinnard,865803068,Dave Jones,2,2,0
431,Darren Jordan,136,Dave Bonwick,2,2,0
431,Darren Jordan,60575249,Ash Thurmer,2,1,1
431,Darren Jordan,90176364,David Page,2,1,1
432,Vincent Elphick,963958265,Rodney Moogan,2,2,0
440,Gordon Carter,349269645,Barry Thornton,2,2,0
440,Gordon Carter,936624299,Peter Gallant,2,1,1
442,Harvey Tuck,466,Ben Fielder,2,1,1
442,Harvey Tuck,293577764,Dave Crosskey,2,1,1
442,Harvey Tuck,363402934,Rod Phillippe,2,2,0
442,Harvey Tuck,426236650,Dave Parrott,2,2,0
442,Harvey Tuck,495939788,Tyrone Davis,2,2,0
442,Harvey Tuck,498330760,Mo Collins,2,1,1
442,Harvey Tuck,630748783,Darren Hills,2,2,0
442,Harvey Tuck,815023707,David Senior,2,1,1
445,Lachlan Monroe,510,Louie Crosskey,2,1,1
445,Lachlan Monroe,514,Tyler Barker,2,1,1
445,Lachlan Monroe,293577764,Dave Crosskey,2,1,1
445,Lachlan Monroe,294944526,Rob Teanby,2,1,1
445,Lachlan Monroe,567624732,Dave Brampton,2,1,1
445,Lachlan Monroe,910809545,Blake Harman,2,1,1
445,Lachlan Monroe,978156264,Bob Paine,2,2,0
448,Adam Bradshaw,704007508,Alan Muir,2,1,1
448,Adam Bradshaw,736672590,Dean Perry,2,1,1
456,Daniel Marcantonio,479,Brian Welsh,2,1,1
456,Daniel Marcantonio,535728699,Fred Cooper,2,1,1
457,Mo Davids,484159049,Tommy Wright,2,1,1
462,Stephen McCullough,670256222,Connor Anderson,2,1,1
466,Ben Fielder,239,Mick Lucas,2,2,0
466,Ben Fielder,266477517,Tony Baxter,2,1,1
466,Ben Fielder,294944526,Rob Teanby,2,1,1
466,Ben Fielder,978156264,Bob Paine,2,2,0
470,Jules Porreca,231445676,Tony Paice,2,2,0
470,Jules Porreca,717256135,Trevor Pickard,2,2,0
470,Jules Porreca,719124015,Tony Power,2,1,1
479,Brian Welsh,84,Gavin McCubbin,2,2,0
479,Brian Welsh,291816585,Jim Somers,2,2,0
479,Brian Welsh,360777082,Mark Bishop,2,1,1
479,Brian Welsh,498330760,Mo Collins,2,2,0
479,Brian Welsh,584652998,Harry Stone,2,2,0
479,Brian Welsh,736672590,Dean Perry,2,2,0
479,Brian Welsh,809984729,Neil Scutt,2,1,1
479,Brian Welsh,822983250,Alasdair Pratt,2,2,0
487,"Jim, Sr. Stevens",880982797,Ray Hunter,2,1,1
488,Roger Harrold,436708540,Bob Henley,2,1,1
488,Roger Harrold,444350794,Richard Freeman,2,2,0
488,Roger Harrold,809647573,John Taylor,2,2,0
492,Malcolm Beal,16,Mick Beck,2,2,0
492,Malcolm Beal,279543944,Peter Maurice,2,2,0
492,Malcolm Beal,429738563,Adam Buckingham,2,1,1
493,M. Holmes,669385277,Steve Towler,2,1,1
494,Simon Bates,246154671,Alan Gunn,2,2,0
494,Simon Bates,363402934,Rod Phillippe,2,1,1
494,Simon Bates,649240057,Mike Childs,2,2,0
496,Lucas Flux,516,Lee Fairclough,2,1,1
497,Ben Melmoth,943667183,John Stone,2,1,1
502,Thomas Reilly,833156731,Jez Saunders,2,2,0
502,Thomas Reilly,962678119,John Worth,2,2,0
504,Aaron Immerson,174147986,Lee Cliff,2,2,0
504,Aaron Immerson,833156731,Jez Saunders,2,1,1
510,Louie Crosskey,266477517,Tony Baxter,2,1,1
511,Steve Pickard,815023707,David Senior,2,2,0
514,Tyler Barker,401846353,Frank McHugh,2,1,1
516,Lee Fairclough,442,Harvey Tuck,2,2,0
516,Lee Fairclough,978156264,Bob Paine,2,1,1
518,Barry Thompson,815023707,David Senior,2,1,1
521,Sam Pullen,457,Mo Davids,2,2,0
521,Sam Pullen,518,Barry Thompson,2,2,0
521,Sam Pullen,76011459,Kane Harman,2,1,1
521,Sam Pullen,491435492,Simon Price,2,1,1
521,Sam Pullen,704007508,Alan Muir,2,1,1
523,Mark Collins,867613624,Ian Dunhill,2,2,0
5820499,Paul Bartlett,9,Michael Cheung,2,2,0
5820499,Paul Bartlett,60575249,Ash Thurmer,2,1,1
5820499,Paul Bartlett,463709832,Danny Wong,2,1,1
5820499,Paul Bartlett,764177688,Barry Martin,2,1,1
5820499,Paul Bartlett,876526526,Ash Bull,2,1,1
11133032,Simon Dent,16,Mick Beck,2,2,0
11133032,Simon Dent,326,Stefan Chandler,2,2,0
11133032,Simon Dent,26970170,Kai Michael,2,1,1
11133032,Simon Dent,133207947,Jake Richardson,2,2,0
11133032,Simon Dent,356397577,David Morgan,2,2,0
11133032,Simon Dent,428102632,Anthony Flynn,2,2,0
11133032,Simon Dent,444639447,Andy Wong,2,2,0
11133032,Simon Dent,515186402,Ben Evans,2,2,0
11133032,Simon Dent,748064029,Paul Hughes,2,2,0
11133032,Simon Dent,764177688,Barry Martin,2,2,0
11133032,Simon Dent,797962517,Dave Lewis,2,2,0
11133032,Simon Dent,927588200,Tokki Yamaguchi,2,2,0
16253983,Tony Simmonds,37,Kieran Tighe,2,2,0
16253983,Tony Simmonds,182,Brian Welfare,2,2,0
16253983,Tony Simmonds,202,Bob Firth,2,2,0
16253983,Tony Simmonds,371,Laurence Park,2,2,0
16253983,Tony Simmonds,372,Jim Race,2,2,0
16253983,Tony Simmonds,112887737,Pip Akehurst,2,2,0
16253983,Tony Simmonds,118679261,Mick Lott,2,1,1
16253983,Tony Simmonds,223983583,Carl Wentworth,2,2,0
16253983,Tony Simmonds,231975313,Danny English,2,1,1
16253983,Tony Simmonds,351143642,Michael Palmer,2,2,0
16253983,Tony Simmonds,426009127,Bav Patel,2,1,1
16253983,Tony Simmonds,463709832,Danny Wong,2,2,0
16253983,Tony Simmonds,490170224,Jamie Matthews,2,2,0
16253983,Tony Simmonds,546362444,Anthony Trory,2,2,0
16253983,Tony Simmonds,598846718,Ben Sorrell,2,2,0
16253983,Tony Simmonds,676753614,Don James,2,2,0
16253983,Tony Simmonds,721321839,Matt Peake,2,1,1
16253983,Tony Simmonds,726498878,Grigory Yashkov,2,1,1
16253983,Tony Simmonds,734416600,DON PENALVER,2,1,1
16253983,Tony Simmonds,822983250,Alasdair Pratt,2,2,0
16253983,Tony Simmonds,948504778,Jon Fordham,2,1,1
16253983,Tony Simmonds,949603489,Pete Bennett,2,1,1
16253983,Tony Simmonds,954639632,Derek Budde,2,2,0
16253983,Tony Simmonds,963206772,Dean Moore,2,2,0
26970170,Kai Michael,60575249,Ash Thurmer,2,2,0
26970170,Kai Michael,133207947,Jake Richardson,2,1,1
26970170,Kai Michael,490170224,Jamie Matthews,2,2,0
26970170,Kai Michael,503528426,Larry Maloney,2,2,0
26970170,Kai Michael,574248035,Tony Mulhern,2,1,1
26970170,Kai Michael,724342701,Nigel Lilley,2,1,1
26970170,Kai Michael,831214643,Tony Shipley,2,1,1
27255501,Tom Lane,35191252,Nigel Hayward,2,1,1
27255501,Tom Lane,394906196,Mick Mabbitt,2,1,1
27255501,Tom Lane,411473516,Ray Canham,2,1,1
27255501,Tom Lane,612265840,Paul Honeysett,2,1,1
27255501,Tom Lane,613893140,Matt Warner,2,1,1
27255501,Tom Lane,669385277,Steve Towler,2,2,0
27255501,Tom Lane,852327692,Andy Fletcher,2,1,1
27255501,Tom Lane,866506631,Mark Smith,2,1,1
27255501,Tom Lane,901024459,Paul Charman,2,2,0
27255501,Tom Lane,910809545,Blake Harman,2,2,0
28382047,Steve Harrington,92,Dale Thomas,2,2,0
28382047,Steve Harrington,279,Tony Slark,2,2,0
28382047,Steve Harrington,349269645,Barry Thornton,2,2,0
28382047,Steve Harrington,430890681,Malcolm Cooper,2,1,1
28382047,Steve Harrington,612265840,Paul Honeysett,2,2,0
28382047,Steve Harrington,809647573,John Taylor,2,1,1
28382047,Steve Harrington,884374645,Wayne Iddon,2,1,1
32061370,Toby Prince-Iles,80,Dave Wells,2,2,0
32061370,Toby Prince-Iles,327,Harold Franks,2,2,0
32061370,Toby Prince-Iles,35191252,Nigel Hayward,2,1,1
32061370,Toby Prince-Iles,56252722,Dave Pither,2,1,1
32061370,Toby Prince-Iles,83590771,Nick Brayne,2,2,0
32061370,Toby Prince-Iles,231445676,Tony Paice,2,1,1
32061370,Toby Prince-Iles,246154671,Alan Gunn,2,1,1
32061370,Toby Prince-Iles,291816585,Jim Somers,2,1,1
32061370,Toby Prince-Iles,402257815,Jim Cumming,2,2,0
32061370,Toby Prince-Iles,584652998,Harry Stone,2,2,0
32061370,Toby Prince-Iles,612265840,Paul Honeysett,2,1,1
32061370,Toby Prince-Iles,732415457,Barry Hall,2,1,1
32061370,Toby Prince-Iles,733453947,Phil Canham,2,1,1
32061370,Toby Prince-Iles,737709582,Tony Browne,2,1,1
32061370,Toby Prince-Iles,740135236,Craig Marchant,2,1,1
32061370,Toby Prince-Iles,833156731,Jez Saunders,2,2,0
32061370,Toby Prince-Iles,845758589,Charlie James,2,2,0
32061370,Toby Prince-Iles,879771694,Darren Parker,2,2,0
32061370,Toby Prince-Iles,884374645,Wayne Iddon,2,1,1
32061370,Toby Prince-Iles,915035871,Kevin Graysmark,2,1,1
34787509,Dave McCarthy,171,Darren Bell,2,2,0
34787509,Dave McCarthy,5820499,Paul Bartlett,2,2,0
34787509,Dave McCarthy,28382047,Steve Harrington,2,2,0
34787509,Dave McCarthy,229719541,Scott Manning,2,2,0
34787509,Dave McCarthy,231975313,Danny English,2,1,1
34787509,Dave McCarthy,323907964,Russ Hughes,2,1,1
34787509,Dave McCarthy,417786644,Eddie Collins,2,2,0
34787509,Dave McCarthy,506581042,Glen Dartnell,2,2,0
34787509,Dave McCarthy,825399596,Pat Adams,2,1,1
34787509,Dave McCarthy,865803068,Dave Jones,2,1,1
35191252,Nigel Hayward,733453947,Phil Canham,2,1,1
35191252,Nigel Hayward,867613624,Ian Dunhill,2,1,1
35191252,Nigel Hayward,873916947,Geoff Akehurst,2,1,1
39289507,Mick Laughlin,92,Dale Thomas,2,2,0
39289507,Mick Laughlin,285,Pete Davie,2,2,0
39289507,Mick Laughlin,292,Jim Mulcahey,2,2,0
39289507,Mick Laughlin,1251038,Ben Clift,2,2,0
39289507,Mick Laughlin,349269645,Barry Thornton,2,2,0
39289507,Mick Laughlin,402257815,Jim Cumming,2,2,0
39289507,Mick Laughlin,415524562,Dave King,2,1,1
39289507,Mick Laughlin,430890681,Malcolm Cooper,2,2,0
39289507,Mick Laughlin,495939788,Tyrone Davis,2,2,0
39289507,Mick Laughlin,573567936,Steve Marriott,2,1,1
39289507,Mick Laughlin,657320021,Brett Strevens,2,2,0
39289507,Mick Laughlin,688252012,Sean Cooper,2,2,0
39289507,Mick Laughlin,844676925,Kieran Williams,2,2,0
39289507,Mick Laughlin,970786910,Kevin Sorrell,2,1,1
39289507,Mick Laughlin,978156264,Bob Paine,2,2,0
41098823,Mikey Booker,117247901,Dave Verey,2,1,1
41098823,Mikey Booker,118679261,Mick Lott,2,2,0
41098823,Mikey Booker,120138229,Adam Butler,2,2,0
41098823,Mikey Booker,436708540,Bob Henley,2,2,0
41098823,Mikey Booker,670034050,John Muzio,2,2,0
41098823,Mikey Booker,688252012,Sean Cooper,2,2,0
41098823,Mikey Booker,703030938,Ollie Thurmer,2,1,1
41098823,Mikey Booker,788605510,Mark Rose,2,2,0
41461520,Luke Pooley,293577764,Dave Crosskey,2,1,1
41461520,Luke Pooley,426236650,Dave Parrott,2,1,1
41461520,Luke Pooley,612265840,Paul Honeysett,2,1,1
41461520,Luke Pooley,804381932,Ryan Harman,2,1,1
41461520,Luke Pooley,845758589,Charlie James,2,1,1
41461520,Luke Pooley,936624299,Peter Gallant,2,1,1
45305697,John Barratt,411473516,Ray Canham,2,1,1
56252722,Dave Pither,319057545,Brendan Lambe,2,2,0
56252722,Dave Pither,392533233,Jack Wright,2,1,1
56252722,Dave Pither,394906196,Mick Mabbitt,2,1,1
56252722,Dave Pither,498330760,Mo Collins,2,1,1
56252722,Dave Pither,809984729,Neil Scutt,2,1,1
56252722,Dave Pither,922772801,Nick Buonanno,2,1,1
59858690,James Constable,34787509,Dave McCarthy,2,2,0
59858690,James Constable,133207947,Jake Richardson,2,1,1
59858690,James Constable,384960657,Dave Lewney,2,2,0
59858690,James Constable,561171273,Andy Norman,2,2,0
59858690,James Constable,617751649,Lee Simpson,2,2,0
59858690,James Constable,619390728,Steve Stylianou,2,1,1
59858690,James Constable,732321233,Nathan Brooks,2,2,0
59858690,James Constable,797962517,Dave Lewis,2,2,0
59858690,James Constable,837429850,Paul Beecham,2,1,1
59858690,James Constable,850059806,Heng Wong,2,1,1
59858690,James Constable,957784480,Harry Banks,2,2,0
60309233,Dan Harley,436708540,Bob Henley,2,1,1
60309233,Dan Harley,573567936,Steve Marriott,2,1,1
60309233,Dan Harley,943667183,John Stone,2,2,0
60575249,Ash Thurmer,61,Paul Gander,2,2,0
60575249,Ash Thurmer,96103077,Paul Norris,2,1,1
60575249,Ash Thurmer,96354463,Rob Pickard,2,2,0
60575249,Ash Thurmer,144293731,Simon Parry,2,1,1
60575249,Ash Thurmer,192463126,Gerry Lindsey,2,2,0
60575249,Ash Thurmer,279543944,Peter Maurice,2,2,0
60575249,Ash Thurmer,523395206,Jamie Lashmar,2,1,1
69745818,Ian Bowles,579164381,Danny Cattell,2,1,1
69745818,Ian Bowles,733453947,Phil Canham,2,1,1
69745818,Ian Bowles,852327692,Andy Fletcher,2,1,1
70159035,Peter Rea,266477517,Tony Baxter,2,2,0
70159035,Peter Rea,271464632,Paul Phillips,2,2,0
70159035,Peter Rea,287057630,Darren Hearn,2,2,0
70159035,Peter Rea,291198629,Tony Burt,2,2,0
70159035,Peter Rea,301960429,Brian Collins,2,1,1
70159035,Peter Rea,417786644,Eddie Collins,2,2,0
70159035,Peter Rea,535728699,Fred Cooper,2,2,0
70159035,Peter Rea,670870044,David Flanagan,2,1,1
70159035,Peter Rea,733453947,Phil Canham,2,1,1
70159035,Peter Rea,833156731,Jez Saunders,2,2,0
70159035,Peter Rea,929636592,Danny Wilson,2,2,0
70159035,Peter Rea,943667183,John Stone,2,1,1
70159035,Peter Rea,968651401,Ryan Grover,2,2,0
76011459,Kane Harman,514,Tyler Barker,2,2,0
76011459,Kane Harman,118679261,Mick Lott,2,2,0
76011459,Kane Harman,174147986,Lee Cliff,2,2,0
76011459,Kane Harman,183400466,David Wright,2,2,0
76011459,Kane Harman,204951513,Mike Holding,2,1,1
76011459,Kane Harman,258549102,Tony Lee,2,1,1
76011459,Kane Harman,294944526,Rob Teanby,2,1,1
76011459,Kane Harman,484159049,Tommy Wright,2,1,1
76011459,Kane Harman,529382351,Greg Foat,2,1,1
76011459,Kane Harman,580088564,Tom Trafford,2,2,0
76011459,Kane Harman,584652998,Harry Stone,2,1,1
76011459,Kane Harman,670870044,David Flanagan,2,1,1
76011459,Kane Harman,688252012,Sean Cooper,2,1,1
76011459,Kane Harman,721321839,Matt Peake,2,2,0
76011459,Kane Harman,724342701,Nigel Lilley,2,2,0
76011459,Kane Harman,845758589,Charlie James,2,2,0
76011459,Kane Harman,901024459,Paul Charman,2,2,0
76011459,Kane Harman,963206772,Dean Moore,2,1,1
76011459,Kane Harman,970786910,Kevin Sorrell,2,1,1
83590771,Nick Brayne,160950731,Locky McCurdy,2,2,0
83590771,Nick Brayne,402257815,Jim Cumming,2,2,0
83590771,Nick Brayne,498330760,Mo Collins,2,2,0
83590771,Nick Brayne,670034050,John Muzio,2,1,1
83590771,Nick Brayne,788605510,Mark Rose,2,2,0
90176364,David Page,307140835,Tony Strange,2,1,1
90176364,David Page,836895047,Ian McKay,2,2,0
96103077,Paul Norris,222,John Newnhan,2,2,0
96103077,Paul Norris,5820499,Paul Bartlett,2,2,0
96103077,Paul Norris,141540226,Pete Hazell,2,2,0
96103077,Paul Norris,147556923,Hong Ming Lee,2,2,0
96103077,Paul Norris,278731588,Lester Grice,2,1,1
96103077,Paul Norris,662568995,Rob Wykes,2,2,0
96103077,Paul Norris,666735933,Mike Collier,2,1,1
96103077,Paul Norris,717256135,Trevor Pickard,2,2,0
96103077,Paul Norris,766684900,John Gillard,2,1,1
96103077,Paul Norris,802242736,Steve Hughes,2,2,0
96103077,Paul Norris,837429850,Paul Beecham,2,2,0
96103077,Paul Norris,947143243,Chris Davis,2,2,0
96354463,Rob Pickard,144293731,Simon Parry,2,1,1
96354463,Rob Pickard,384960657,Dave Lewney,2,1,1
96354463,Rob Pickard,617751649,Lee Simpson,2,2,0
96354463,Rob Pickard,619390728,Steve Stylianou,2,1,1
96354463,Rob Pickard,773216781,Sean Payne,2,2,0
96354463,Rob Pickard,825399596,Pat Adams,2,1,1
101751030,Simon Uddin,32061370,Toby Prince-Iles,2,2,0
101751030,Simon Uddin,160950731,Locky McCurdy,2,1,1
101751030,Simon Uddin,349269645,Barry Thornton,2,1,1
101751030,Simon Uddin,417786644,Eddie Collins,2,2,0
101751030,Simon Uddin,535728699,Fred Cooper,2,1,1
101751030,Simon Uddin,936624299,Peter Gallant,2,1,1
110039677,Mick Miller,75,Chris Rea,2,2,0
110039677,Mick Miller,153,Tony Leach,2,2,0
110039677,Mick Miller,395,Herby Burchell,2,2,0
110039677,Mick Miller,202090738,Alan Head,2,1,1
110039677,Mick Miller,227209116,Peter Rawlinson,2,1,1
110039677,Mick Miller,291198629,Tony Burt,2,2,0
110039677,Mick Miller,351143642,Michael Palmer,2,1,1
110039677,Mick Miller,480154054,Jim Dunstall,2,2,0
110039677,Mick Miller,506320151,Frank Taylor,2,1,1
110039677,Mick Miller,836895047,Ian McKay,2,1,1
110039677,Mick Miller,858283721,Dave Dunstall,2,1,1
110039677,Mick Miller,911104566,Steve Linton,2,1,1
110039677,Mick Miller,954080507,Sam Corsby,2,1,1
112887737,Pip Akehurst,190,Paul Mitchell,2,2,0
112887737,Pip Akehurst,114184042,Ian Smith,2,1,1
112887737,Pip Akehurst,282510619,Harry Green,2,2,0
112887737,Pip Akehurst,436708540,Bob Henley,2,2,0
112887737,Pip Akehurst,444639447,Andy Wong,2,1,1
112887737,Pip Akehurst,463709832,Danny Wong,2,1,1
112887737,Pip Akehurst,484159049,Tommy Wright,2,1,1
112887737,Pip Akehurst,529382351,Greg Foat,2,2,0
112887737,Pip Akehurst,649078882,Richard Barrett,2,2,0
112887737,Pip Akehurst,809568302,Mark Johnson,2,1,1
112887737,Pip Akehurst,837429850,Paul Beecham,2,1,1
112887737,Pip Akehurst,866506631,Mark Smith,2,2,0
112887737,Pip Akehurst,880982797,Ray Hunter,2,2,0
112887737,Pip Akehurst,899206834,Jez Downs,2,2,0
112887737,Pip Akehurst,949603489,Pete Bennett,2,2,0
112887737,Pip Akehurst,970786910,Kevin Sorrell,2,2,0
112887737,Pip Akehurst,971308746,Clive Harman,2,2,0
112887737,Pip Akehurst,974385564,Danny Booker,2,1,1
114007838,John Paine,417786644,Eddie Collins,2,2,0
114007838,John Paine,529382351,Greg Foat,2,1,1
114007838,John Paine,733453947,Phil Canham,2,1,1
114184042,Ian Smith,235,Derek Conley,2,2,0
114184042,Ian Smith,204951513,Mike Holding,2,1,1
114184042,Ian Smith,327948141,Ross Etheridge,2,1,1
114184042,Ian Smith,351143642,Michael Palmer,2,2,0
114184042,Ian Smith,409212679,Mark Chapman,2,1,1
114184042,Ian Smith,436708540,Bob Henley,2,1,1
114184042,Ian Smith,463709832,Danny Wong,2,1,1
114184042,Ian Smith,529382351,Greg Foat,2,1,1
114184042,Ian Smith,598846718,Ben Sorrell,2,1,1
114184042,Ian Smith,669385277,Steve Towler,2,2,0
114184042,Ian Smith,670034050,John Muzio,2,1,1
114184042,Ian Smith,703030938,Ollie Thurmer,2,1,1
114184042,Ian Smith,736672590,Dean Perry,2,1,1
114184042,Ian Smith,747966869,Richard Morgan,2,2,0
114184042,Ian Smith,822983250,Alasdair Pratt,2,1,1
114184042,Ian Smith,837429850,Paul Beecham,2,1,1
114184042,Ian Smith,899206834,Jez Downs,2,2,0
114319292,Oliver Gorrod,287057630,Darren Hearn,2,2,0
114319292,Oliver Gorrod,501266206,David Fox,2,1,1
114319292,Oliver Gorrod,567316488,Lee Millyard,2,1,1
114319292,Oliver Gorrod,688252012,Sean Cooper,2,2,0
114319292,Oliver Gorrod,807603289,Kevin Gardner,2,1,1
114319292,Oliver Gorrod,929636592,Danny Wilson,2,2,0
114319292,Oliver Gorrod,949603489,Pete Bennett,2,1,1
114319292,Oliver Gorrod,971308746,Clive Harman,2,1,1
117247901,Dave Verey,124,Dave Tristram,2,2,0
117247901,Dave Verey,202,Bob Firth,2,2,0
117247901,Dave Verey,171346729,Des Heasman,2,2,0
117247901,Dave Verey,364867274,Dave Lucking,2,2,0
117247901,Dave Verey,436708540,Bob Henley,2,2,0
117247901,Dave Verey,848997254,Tom Parker,2,1,1
117247901,Dave Verey,884365412,Dave Haslam,2,1,1
117247901,Dave Verey,947620111,Neil Cutler,2,2,0
117247901,Dave Verey,963206772,Dean Moore,2,2,0
118679261,Mick Lott,174147986,Lee Cliff,2,1,1
118679261,Mick Lott,278731588,Lester Grice,2,1,1
118679261,Mick Lott,360777082,Mark Bishop,2,2,0
118679261,Mick Lott,463709832,Danny Wong,2,1,1
118679261,Mick Lott,623613383,Chris Marsh,2,1,1
120138229,Adam Butler,27255501,Tom Lane,2,2,0
120138229,Adam Butler,124523642,Tom Hayes,2,1,1
120138229,Adam Butler,360777082,Mark Bishop,2,1,1
120138229,Adam Butler,455401154,Kai Ellis,2,1,1
120138229,Adam Butler,463709832,Danny Wong,2,2,0
120138229,Adam Butler,809984729,Neil Scutt,2,1,1
120138229,Adam Butler,878576746,Jon Hall,2,2,0
120138229,Adam Butler,970786910,Kevin Sorrell,2,2,0
121263797,Jim Pelling,341869673,Nigel Stilwell,2,1,1
121263797,Jim Pelling,948504778,Jon Fordham,2,1,1
123792666,Jamie Thomas,371,Laurence Park,2,2,0
123792666,Jamie Thomas,32061370,Toby Prince-Iles,2,2,0
123792666,Jamie Thomas,293577764,Dave Crosskey,2,2,0
123792666,Jamie Thomas,392533233,Jack Wright,2,2,0
123792666,Jamie Thomas,501266206,David Fox,2,1,1
123792666,Jamie Thomas,535728699,Fred Cooper,2,1,1
123792666,Jamie Thomas,809984729,Neil Scutt,2,1,1
123792666,Jamie Thomas,845758589,Charlie James,2,2,0
123792666,Jamie Thomas,856755662,David Marsh,2,2,0
124523642,Tom Hayes,149,Tony Nealgrove,2,2,0
124523642,Tom Hayes,174147986,Lee Cliff,2,2,0
124523642,Tom Hayes,360777082,Mark Bishop,2,1,1
124523642,Tom Hayes,384960657,Dave Lewney,2,1,1
124523642,Tom Hayes,386517733,Ady Halley,2,2,0
124523642,Tom Hayes,428102632,Anthony Flynn,2,1,1
124523642,Tom Hayes,436708540,Bob Henley,2,1,1
124523642,Tom Hayes,463709832,Danny Wong,2,1,1
124523642,Tom Hayes,480154054,Jim Dunstall,2,2,0
124523642,Tom Hayes,537640521,Ian Stoner,2,2,0
124523642,Tom Hayes,574248035,Tony Mulhern,2,1,1
124523642,Tom Hayes,677110925,Jake Dunstall,2,2,0
124523642,Tom Hayes,680442672,Scott Lawson,2,1,1
124523642,Tom Hayes,719124015,Tony Power,2,1,1
124523642,Tom Hayes,734416600,DON PENALVER,2,1,1
124523642,Tom Hayes,805165161,Steve Owen,2,2,0
124523642,Tom Hayes,844676925,Kieran Williams,2,2,0
124523642,Tom Hayes,878576746,Jon Hall,2,2,0
133207947,Jake Richardson,16,Mick Beck,2,2,0
133207947,Jake Richardson,5820499,Paul Bartlett,2,2,0
133207947,Jake Richardson,141540226,Pete Hazell,2,1,1
133207947,Jake Richardson,144293731,Simon Parry,2,2,0
133207947,Jake Richardson,384960657,Dave Lewney,2,1,1
133207947,Jake Richardson,490170224,Jamie Matthews,2,2,0
133207947,Jake Richardson,600385553,Darren Welfare,2,1,1
133207947,Jake Richardson,608140548,David Gillingham,2,1,1
133207947,Jake Richardson,629014363,Lee Shepherd,2,2,0
133207947,Jake Richardson,654650203,Alan O'Sullivan,2,2,0
133207947,Jake Richardson,688778183,Dean Paice,2,1,1
133207947,Jake Richardson,766684900,John Gillard,2,1,1
133207947,Jake Richardson,800114325,Roger Whiteley,2,2,0
133207947,Jake Richardson,810143915,Ben Welfare,2,1,1
133207947,Jake Richardson,876526526,Ash Bull,2,2,0
133207947,Jake Richardson,954297832,Pav Sareen,2,1,1
133207947,Jake Richardson,963958265,Rodney Moogan,2,2,0
141540226,Pete Hazell,16,Mick Beck,2,2,0
141540226,Pete Hazell,464085958,Gerwyn Bowen,2,2,0
141540226,Pete Hazell,515186402,Ben Evans,2,1,1
141540226,Pete Hazell,600385553,Darren Welfare,2,2,0
141540226,Pete Hazell,957784480,Harry Banks,2,1,1
141540226,Pete Hazell,974385564,Danny Booker,2,1,1
144293731,Simon Parry,426009127,Bav Patel,2,1,1
144293731,Simon Parry,680442672,Scott Lawson,2,1,1
144293731,Simon Parry,754250007,Freddie Blunden,2,1,1
144293731,Simon Parry,802242736,Steve Hughes,2,1,1
144293731,Simon Parry,963958265,Rodney Moogan,2,1,1
144776055,Brian Wilkes,247,Mick Justice,2,2,0
144776055,Brian Wilkes,307,Alister Morrison,2,2,0
144776055,Brian Wilkes,28382047,Steve Harrington,2,2,0
144776055,Brian Wilkes,171346729,Des Heasman,2,1,1
144776055,Brian Wilkes,172899919,Derek Dale,2,2,0
144776055,Brian Wilkes,174147986,Lee Cliff,2,1,1
144776055,Brian Wilkes,216787426,Jack Perrin,2,2,0
144776055,Brian Wilkes,293577764,Dave Crosskey,2,2,0
144776055,Brian Wilkes,392533233,Jack Wright,2,1,1
144776055,Brian Wilkes,417786644,Eddie Collins,2,2,0
144776055,Brian Wilkes,529382351,Greg Foat,2,1,1
144776055,Brian Wilkes,809647573,John Taylor,2,1,1
144776055,Brian Wilkes,820231590,Alan Rook,2,2,0
144776055,Brian Wilkes,839313888,Kevin Chrysanthou,2,2,0
144776055,Brian Wilkes,845758589,Charlie James,2,1,1
144776055,Brian Wilkes,889234854,Paul Smith,2,1,1
144776055,Brian Wilkes,899206834,Jez Downs,2,1,1
144776055,Brian Wilkes,953512654,Les Berry,2,1,1
144776055,Brian Wilkes,970786910,Kevin Sorrell,2,1,1
146404254,Randall Griffiths,27255501,Tom Lane,2,2,0
146404254,Randall Griffiths,484159049,Tommy Wright,2,1,1
146404254,Randall Griffiths,567316488,Lee Millyard,2,1,1
146404254,Randall Griffiths,732415457,Barry Hall,2,1,1
147556923,Hong Ming Lee,222,John Newnhan,2,2,0
147556923,Hong Ming Lee,384960657,Dave Lewney,2,2,0
147556923,Hong Ming Lee,436708540,Bob Henley,2,1,1
147556923,Hong Ming Lee,837429850,Paul Beecham,2,2,0
152643729,Lew Heath,831214643,Tony Shipley,2,2,0
157282960,Vern Asbury,974385564,Danny Booker,2,1,1
160950731,Locky McCurdy,285,Pete Davie,2,2,0
160950731,Locky McCurdy,386,Sam Hains,2,2,0
160950731,Locky McCurdy,35191252,Nigel Hayward,2,2,0
160950731,Locky McCurdy,417786644,Eddie Collins,2,2,0
160950731,Locky McCurdy,503528426,Larry Maloney,2,1,1
160950731,Locky McCurdy,598552542,John Colgan,2,2,0
160950731,Locky McCurdy,598846718,Ben Sorrell,2,1,1
160950731,Locky McCurdy,649240057,Mike Childs,2,2,0
163959771,Alex El-Deweiny,174147986,Lee Cliff,2,2,0
171346729,Des Heasman,172646809,Robin Powell,2,2,0
171346729,Des Heasman,207592931,(shorty) Gediminas Aleksandravicius,2,1,1
171346729,Des Heasman,231445676,Tony Paice,2,1,1
171346729,Des Heasman,319057545,Brendan Lambe,2,2,0
171346729,Des Heasman,402257815,Jim Cumming,2,2,0
171346729,Des Heasman,573567936,Steve Marriott,2,2,0
171346729,Des Heasman,752709358,Chris Mason,2,1,1
171346729,Des Heasman,809647573,John Taylor,2,2,0
171346729,Des Heasman,949603489,Pete Bennett,2,1,1
171346729,Des Heasman,966905561,Tony Dade,2,2,0
172646809,Robin Powell,258549102,Tony Lee,2,1,1
172646809,Robin Powell,294944526,Rob Teanby,2,1,1
172646809,Robin Powell,295120010,Andy Yarrow,2,1,1
172646809,Robin Powell,417786644,Eddie Collins,2,2,0
172646809,Robin Powell,501266206,David Fox,2,2,0
172646809,Robin Powell,529382351,Greg Foat,2,1,1
172899919,Derek Dale,574248035,Tony Mulhern,2,1,1
174147986,Lee Cliff,181,Dave Roughley,2,2,0
174147986,Lee Cliff,392533233,Jack Wright,2,2,0
174147986,Lee Cliff,567316488,Lee Millyard,2,1,1
174147986,Lee Cliff,669385277,Steve Towler,2,1,1
174147986,Lee Cliff,732415457,Barry Hall,2,1,1
174147986,Lee Cliff,805165161,Steve Owen,2,1,1
174147986,Lee Cliff,809647573,John Taylor,2,1,1
174147986,Lee Cliff,833156731,Jez Saunders,2,1,1
174147986,Lee Cliff,873916947,Geoff Akehurst,2,2,0
174147986,Lee Cliff,911104566,Steve Linton,2,2,0
174147986,Lee Cliff,929636592,Danny Wilson,2,1,1
174147986,Lee Cliff,954080507,Sam Corsby,2,2,0
183400466,David Wright,160950731,Locky McCurdy,2,2,0
202090738,Alan Head,115,Jim Collins,2,2,0
202090738,Alan Head,190,Paul Mitchell,2,2,0
202090738,Alan Head,231445676,Tony Paice,2,1,1
202090738,Alan Head,293122482,Stuart Maplesden,2,1,1
202090738,Alan Head,417786644,Eddie Collins,2,2,0
202090738,Alan Head,429738563,Adam Buckingham,2,1,1
204951513,Mike Holding,84,Gavin McCubbin,2,2,0
204951513,Mike Holding,225247539,Barry Knight,2,1,1
204951513,Mike Holding,363402934,Rod Phillippe,2,2,0
204951513,Mike Holding,401846353,Frank McHugh,2,1,1
204951513,Mike Holding,412256116,Andy Sutton,2,1,1
204951513,Mike Holding,649240057,Mike Childs,2,2,0
204951513,Mike Holding,878576746,Jon Hall,2,1,1
204951513,Mike Holding,978156264,Bob Paine,2,2,0
207592931,(shorty) Gediminas Aleksandravicius,326225304,Ian Raeburn,2,1,1
207592931,(shorty) Gediminas Aleksandravicius,535728699,Fred Cooper,2,2,0
207592931,(shorty) Gediminas Aleksandravicius,724342701,Nigel Lilley,2,2,0
207592931,(shorty) Gediminas Aleksandravicius,732415457,Barry Hall,2,1,1
207592931,(shorty) Gediminas Aleksandravicius,963206772,Dean Moore,2,1,1
212940364,Wayne Jenkinson,574248035,Tony Mulhern,2,2,0
213264678,Martin Hall,78,Kevin Baker,2,2,0
213264678,Martin Hall,272,Carlo Lupi,2,2,0
213264678,Martin Hall,451309825,Maurice Wickens,2,1,1
213264678,Martin Hall,641692362,Bob Taylor,2,1,1
213264678,Martin Hall,866506631,Mark Smith,2,1,1
216787426,Jack Perrin,326225304,Ian Raeburn,2,1,1
216787426,Jack Perrin,386517733,Ady Halley,2,2,0
216787426,Jack Perrin,495939788,Tyrone Davis,2,1,1
216787426,Jack Perrin,529382351,Greg Foat,2,2,0
216787426,Jack Perrin,929636592,Danny Wilson,2,1,1
216787426,Jack Perrin,936624299,Peter Gallant,2,2,0
216787426,Jack Perrin,978156264,Bob Paine,2,2,0
223983583,Carl Wentworth,229719541,Scott Manning,2,1,1
223983583,Carl Wentworth,231445676,Tony Paice,2,1,1
223983583,Carl Wentworth,495939788,Tyrone Davis,2,2,0
223983583,Carl Wentworth,529382351,Greg Foat,2,1,1
223983583,Carl Wentworth,567624732,Dave Brampton,2,2,0
223983583,Carl Wentworth,804381932,Ryan Harman,2,1,1
223983583,Carl Wentworth,966905561,Tony Dade,2,2,0
225247539,Barry Knight,202,Bob Firth,2,2,0
225247539,Barry Knight,174147986,Lee Cliff,2,2,0
225247539,Barry Knight,225850882,John McLellan,2,1,1
225247539,Barry Knight,291198629,Tony Burt,2,2,0
225247539,Barry Knight,411473516,Ray Canham,2,1,1
225247539,Barry Knight,567316488,Lee Millyard,2,1,1
225247539,Barry Knight,677110925,Jake Dunstall,2,1,1
225247539,Barry Knight,745152759,Kevin Jewell,2,2,0
225850882,John McLellan,124,Dave Tristram,2,2,0
225850882,John McLellan,300,Graham Smart,2,2,0
225850882,John McLellan,319,John Lojo,2,2,0
225850882,John McLellan,487,"Jim, Sr. Stevens",2,2,0
225850882,John McLellan,83590771,Nick Brayne,2,2,0
225850882,John McLellan,124523642,Tom Hayes,2,2,0
225850882,John McLellan,306438070,Martin Stocker,2,2,0
225850882,John McLellan,402257815,Jim Cumming,2,2,0
225850882,John McLellan,463709832,Danny Wong,2,1,1
225850882,John McLellan,579164381,Danny Cattell,2,2,0
225850882,John McLellan,713064363,John Trory,2,2,0
225850882,John McLellan,734416600,DON PENALVER,2,2,0
225850882,John McLellan,809788967,Brett Williams,2,1,1
225850882,John McLellan,880982797,Ray Hunter,2,1,1
225850882,John McLellan,899206834,Jez Downs,2,2,0
225850882,John McLellan,949603489,Pete Bennett,2,1,1
225850882,John McLellan,991823299,Miggy Louro,2,2,0
227209116,Peter Rawlinson,284,Ray Bradley,2,2,0
227209116,Peter Rawlinson,388,Jacob Stevenson,2,2,0
227209116,Peter Rawlinson,556095121,Tom Wright,2,2,0
229719541,Scott Manning,275,Brian Balchin,2,2,0
229719541,Scott Manning,144776055,Brian Wilkes,2,2,0
229719541,Scott Manning,172646809,Robin Powell,2,2,0
229719541,Scott Manning,258549102,Tony Lee,2,2,0
229719541,Scott Manning,293577764,Dave Crosskey,2,2,0
229719541,Scott Manning,301960429,Brian Collins,2,1,1
229719541,Scott Manning,386517733,Ady Halley,2,1,1
229719541,Scott Manning,402257815,Jim Cumming,2,2,0
229719541,Scott Manning,444339215,Steve Richards,2,2,0
229719541,Scott Manning,444350794,Richard Freeman,2,2,0
229719541,Scott Manning,464085958,Gerwyn Bowen,2,1,1
229719541,Scott Manning,495939788,Tyrone Davis,2,2,0
229719541,Scott Manning,546362444,Anthony Trory,2,2,0
229719541,Scott Manning,646614924,Norman Moye,2,2,0
229719541,Scott Manning,657320021,Brett Strevens,2,1,1
229719541,Scott Manning,713064363,John Trory,2,2,0
229719541,Scott Manning,745152759,Kevin Jewell,2,2,0
229719541,Scott Manning,822983250,Alasdair Pratt,2,2,0
229719541,Scott Manning,835713833,Olly Stewart,2,1,1
229719541,Scott Manning,858283721,Dave Dunstall,2,2,0
229719541,Scott Manning,884374645,Wayne Iddon,2,2,0
231445676,Tony Paice,39289507,Mick Laughlin,2,2,0
231445676,Tony Paice,69745818,Ian Bowles,2,2,0
231445676,Tony Paice,271464632,Paul Phillips,2,1,1
231445676,Tony Paice,351143642,Michael Palmer,2,1,1
231445676,Tony Paice,394906196,Mick Mabbitt,2,1,1
231445676,Tony Paice,537640521,Ian Stoner,2,1,1
231445676,Tony Paice,567624732,Dave Brampton,2,1,1
231445676,Tony Paice,573567936,Steve Marriott,2,1,1
231445676,Tony Paice,649240057,Mike Childs,2,2,0
231445676,Tony Paice,674307680,Neil McCafferty,2,2,0
231445676,Tony Paice,677110925,Jake Dunstall,2,1,1
231445676,Tony Paice,754250007,Freddie Blunden,2,1,1
231445676,Tony Paice,831214643,Tony Shipley,2,1,1
231445676,Tony Paice,884365412,Dave Haslam,2,1,1
231445676,Tony Paice,953512654,Les Berry,2,2,0
231975313,Danny English,61,Paul Gander,2,2,0
231975313,Danny English,174,Brian Grant,2,2,0
231975313,Danny English,192463126,Gerry Lindsey,2,2,0
231975313,Danny English,506320151,Frank Taylor,2,1,1
231975313,Danny English,529382351,Greg Foat,2,1,1
231975313,Danny English,732321233,Nathan Brooks,2,1,1
231975313,Danny English,810143915,Ben Welfare,2,2,0
231975313,Danny English,899206834,Jez Downs,2,2,0
231975313,Danny English,957784480,Harry Banks,2,1,1
231975313,Danny English,970786910,Kevin Sorrell,2,1,1
246154671,Alan Gunn,279,Tony Slark,2,2,0
246154671,Alan Gunn,266477517,Tony Baxter,2,1,1
246154671,Alan Gunn,567624732,Dave Brampton,2,1,1
246154671,Alan Gunn,584652998,Harry Stone,2,1,1
246154671,Alan Gunn,598552542,John Colgan,2,1,1
251261063,Rob Barnes,287057630,Darren Hearn,2,2,0
251261063,Rob Barnes,867613624,Ian Dunhill,2,1,1
254776886,Leighton Cole,573567936,Steve Marriott,2,2,0
254776886,Leighton Cole,971308746,Clive Harman,2,1,1
256835252,James Burton,430890681,Malcolm Cooper,2,1,1
256835252,James Burton,503528426,Larry Maloney,2,1,1
258340682,John Derret,598846718,Ben Sorrell,2,2,0
258340682,John Derret,949603489,Pete Bennett,2,2,0
258340682,John Derret,970786910,Kevin Sorrell,2,1,1
258549102,Tony Lee,386517733,Ady Halley,2,1,1
258549102,Tony Lee,820231590,Alan Rook,2,2,0
259288142,Dale Edmonds,971308746,Clive Harman,2,1,1
266477517,Tony Baxter,92,Dale Thomas,2,2,0
266477517,Tony Baxter,280,Terry Slark,2,2,0
266477517,Tony Baxter,316,Paul Redgate,2,2,0
266477517,Tony Baxter,291198629,Tony Burt,2,2,0
266477517,Tony Baxter,491435492,Simon Price,2,1,1
266477517,Tony Baxter,498330760,Mo Collins,2,1,1
266477517,Tony Baxter,556095121,Tom Wright,2,1,1
266477517,Tony Baxter,584652998,Harry Stone,2,2,0
266477517,Tony Baxter,943667183,John Stone,2,1,1
266591683,Chris Roche,193,Gary Goodman,2,2,0
266591683,Chris Roche,278731588,Lester Grice,2,1,1
266591683,Chris Roche,501266206,David Fox,2,2,0
266591683,Chris Roche,608140548,David Gillingham,2,1,1
266591683,Chris Roche,717256135,Trevor Pickard,2,1,1
266591683,Chris Roche,747966869,Richard Morgan,2,2,0
266591683,Chris Roche,899206834,Jez Downs,2,1,1
266591683,Chris Roche,929636592,Danny Wilson,2,2,0
271464632,Paul Phillips,41461520,Luke Pooley,2,2,0
271464632,Paul Phillips,225247539,Barry Knight,2,2,0
271464632,Paul Phillips,351143642,Michael Palmer,2,2,0
271464632,Paul Phillips,495939788,Tyrone Davis,2,2,0
271464632,Paul Phillips,503528426,Larry Maloney,2,1,1
271464632,Paul Phillips,504949622,Jimmy Moseley,2,2,0
271464632,Paul Phillips,529382351,Greg Foat,2,2,0
271464632,Paul Phillips,573567936,Steve Marriott,2,2,0
271464632,Paul Phillips,649240057,Mike Childs,2,2,0
271464632,Paul Phillips,704007508,Alan Muir,2,1,1
271464632,Paul Phillips,717256135,Trevor Pickard,2,1,1
271464632,Paul Phillips,835713833,Olly Stewart,2,1,1
271464632,Paul Phillips,858283721,Dave Dunstall,2,1,1
275738778,John Da Silva,84,Gavin McCubbin,2,2,0
275738778,John Da Silva,179,Mick Jones,2,2,0
275738778,John Da Silva,182,Brian Welfare,2,2,0
275738778,John Da Silva,202,Bob Firth,2,2,0
275738778,John Da Silva,247,Mick Justice,2,2,0
275738778,John Da Silva,225850882,John McLellan,2,2,0
275738778,John Da Silva,291816585,Jim Somers,2,1,1
275738778,John Da Silva,677110925,Jake Dunstall,2,2,0
275738778,John Da Silva,717256135,Trevor Pickard,2,1,1
275738778,John Da Silva,954080507,Sam Corsby,2,1,1
278731588,Lester Grice,222,John Newnhan,2,2,0
278731588,Lester Grice,235,Derek Conley,2,2,0
278731588,Lester Grice,124523642,Tom Hayes,2,2,0
278731588,Lester Grice,231445676,Tony Paice,2,2,0
278731588,Lester Grice,258340682,John Derret,2,2,0
278731588,Lester Grice,279543944,Peter Maurice,2,2,0
278731588,Lester Grice,323907964,Russ Hughes,2,1,1
278731588,Lester Grice,463709832,Danny Wong,2,1,1
278731588,Lester Grice,503528426,Larry Maloney,2,2,0
278731588,Lester Grice,600385553,Darren Welfare,2,1,1
278731588,Lester Grice,764177688,Barry Martin,2,2,0
278731588,Lester Grice,797962517,Dave Lewis,2,1,1
278731588,Lester Grice,802242736,Stephen Hughes,2,1,1
278731588,Lester Grice,836895047,Ian McKay,2,1,1
278731588,Lester Grice,884365412,Dave Haslam,2,1,1
278731588,Lester Grice,947620111,Neil Cutler,2,2,0
278731588,Lester Grice,954297832,Pav Sareen,2,1,1
279543944,Peter Maurice,198,Chris Playford,2,2,0
279543944,Peter Maurice,293577764,Dave Crosskey,2,1,1
279543944,Peter Maurice,351143642,Michael Palmer,2,1,1
279543944,Peter Maurice,417786644,Eddie Collins,2,2,0
279543944,Peter Maurice,495939788,Tyrone Davis,2,2,0
279543944,Peter Maurice,503528426,Larry Maloney,2,2,0
279543944,Peter Maurice,579164381,Danny Cattell,2,1,1
279543944,Peter Maurice,804381932,Ryan Harman,2,1,1
279543944,Peter Maurice,971308746,Clive Harman,2,1,1
282510619,Harry Green,721321839,Matt Peake,2,1,1
282510619,Harry Green,848997254,Tom Parker,2,1,1
282510619,Harry Green,954080507,Sam Corsby,2,1,1
287057630,Darren Hearn,409212679,Mark Chapman,2,1,1
287057630,Darren Hearn,426236650,Dave Parrott,2,1,1
287057630,Darren Hearn,480154054,Jim Dunstall,2,1,1
287057630,Darren Hearn,839313888,Kevin Chrysanthou,2,1,1
287057630,Darren Hearn,966905561,Tony Dade,2,2,0
287057630,Darren Hearn,978156264,Bob Paine,2,1,1
288891270,Lewis Copping,39289507,Mick Laughlin,2,2,0
288891270,Lewis Copping,69745818,Ian Bowles,2,2,0
288891270,Lewis Copping,574248035,Tony Mulhern,2,2,0
288891270,Lewis Copping,737709582,Tony Browne,2,1,1
288891270,Lewis Copping,910809545,Blake Harman,2,2,0
289915561,Craig Dummer,278731588,Lester Grice,2,2,0
289915561,Craig Dummer,426009127,Bav Patel,2,1,1
289915561,Craig Dummer,646410961,Paul Scorer,2,1,1
289915561,Craig Dummer,754250007,Freddie Blunden,2,1,1
289915561,Craig Dummer,773216781,Sean Payne,2,1,1
291198629,Tony Burt,41461520,Luke Pooley,2,2,0
291198629,Tony Burt,495939788,Tyrone Davis,2,2,0
291816585,Jim Somers,293577764,Dave Crosskey,2,1,1
291816585,Jim Somers,392533233,Jack Wright,2,2,0
291816585,Jim Somers,410854609,Dave Lowe,2,1,1
291816585,Jim Somers,674307680,Neil McCafferty,2,1,1
291816585,Jim Somers,788605510,Mark Rose,2,1,1
291816585,Jim Somers,884374645,Wayne Iddon,2,2,0
293122482,Stuart Maplesden,27255501,Tom Lane,2,2,0
293122482,Stuart Maplesden,172646809,Robin Powell,2,2,0
293122482,Stuart Maplesden,444639447,Andy Wong,2,1,1
293122482,Stuart Maplesden,732321233,Nathan Brooks,2,1,1
293122482,Stuart Maplesden,733453947,Phil Canham,2,1,1
293122482,Stuart Maplesden,954639632,Derek Budde,2,2,0
293577764,Dave Crosskey,248,R. Teagle,2,2,0
293577764,Dave Crosskey,457,Mo Davids,2,2,0
293577764,Dave Crosskey,294944526,Rob Teanby,2,1,1
293577764,Dave Crosskey,363402934,Rod Phillippe,2,1,1
293577764,Dave Crosskey,480154054,Jim Dunstall,2,2,0
293577764,Dave Crosskey,501266206,David Fox,2,2,0
293577764,Dave Crosskey,556095121,Tom Wright,2,1,1
293577764,Dave Crosskey,713064363,John Trory,2,1,1
293577764,Dave Crosskey,815023707,David Senior,2,1,1
293577764,Dave Crosskey,845758589,Charlie James,2,1,1
293577764,Dave Crosskey,867613624,Ian Dunhill,2,1,1
293577764,Dave Crosskey,880982797,Ray Hunter,2,1,1
293577764,Dave Crosskey,953512654,Les Berry,2,1,1
294944526,Rob Teanby,286,Paul Baker,2,2,0
294944526,Rob Teanby,231445676,Tony Paice,2,2,0
294944526,Rob Teanby,287057630,Darren Hearn,2,2,0
294944526,Rob Teanby,363402934,Rod Phillippe,2,2,0
294944526,Rob Teanby,444339215,Steve Richards,2,2,0
294944526,Rob Teanby,495939788,Tyrone Davis,2,2,0
294944526,Rob Teanby,529382351,Greg Foat,2,2,0
294944526,Rob Teanby,649240057,Mike Childs,2,1,1
294944526,Rob Teanby,815023707,David Senior,2,2,0
294944526,Rob Teanby,845758589,Charlie James,2,1,1
294944526,Rob Teanby,856755662,David Marsh,2,1,1
301960429,Brian Collins,83,Eric Gumbrell,2,2,0
301960429,Brian Collins,202,Bob Firth,2,2,0
301960429,Brian Collins,493,M. Holmes,2,2,0
301960429,Brian Collins,271464632,Paul Phillips,2,2,0
301960429,Brian Collins,275738778,John Da Silva,2,2,0
301960429,Brian Collins,382970973,Paul Shaw,2,1,1
301960429,Brian Collins,386517733,Ady Halley,2,2,0
301960429,Brian Collins,567624732,Dave Brampton,2,1,1
301960429,Brian Collins,669385277,Steve Towler,2,2,0
301960429,Brian Collins,713064363,John Trory,2,2,0
301960429,Brian Collins,733453947,Phil Canham,2,2,0
301960429,Brian Collins,831214643,Tony Shipley,2,2,0
301960429,Brian Collins,844676925,Kieran Williams,2,2,0
301960429,Brian Collins,884374645,Wayne Iddon,2,1,1
301960429,Brian Collins,943667183,John Stone,2,2,0
304563362,Dan Marchant,444339215,Steve Richards,2,1,1
304563362,Dan Marchant,490170224,Jamie Matthews,2,1,1
304563362,Dan Marchant,831214643,Tony Shipley,2,2,0
306438070,Martin Stocker,1251038,Ben Clift,2,2,0
306438070,Martin Stocker,598846718,Ben Sorrell,2,1,1
306438070,Martin Stocker,680442672,Scott Lawson,2,1,1
306438070,Martin Stocker,788605510,Mark Rose,2,1,1
306438070,Martin Stocker,836895047,Ian McKay,2,1,1
306438070,Martin Stocker,880982797,Ray Hunter,2,1,1
306438070,Martin Stocker,954297832,Pav Sareen,2,1,1
307140835,Tony Strange,350,M. Hudson,2,2,0
307140835,Tony Strange,133207947,Jake Richardson,2,2,0
307140835,Tony Strange,323907964,Russ Hughes,2,1,1
307140835,Tony Strange,356397577,David Morgan,2,1,1
307140835,Tony Strange,646410961,Paul Scorer,2,1,1
307140835,Tony Strange,717256135,Trevor Pickard,2,2,0
307140835,Tony Strange,732321233,Nathan Brooks,2,2,0
307140835,Tony Strange,963958265,Rodney Moogan,2,2,0
319057545,Brendan Lambe,149,Tony Nealgrove,2,2,0
319057545,Brendan Lambe,279,Tony Slark,2,2,0
319057545,Brendan Lambe,384,Bryan Beck,2,2,0
319057545,Brendan Lambe,225247539,Barry Knight,2,2,0
319057545,Brendan Lambe,266477517,Tony Baxter,2,2,0
319057545,Brendan Lambe,349269645,Barry Thornton,2,2,0
319057545,Brendan Lambe,386517733,Ady Halley,2,1,1
319057545,Brendan Lambe,392533233,Jack Wright,2,1,1
319057545,Brendan Lambe,415524562,Dave King,2,2,0
319057545,Brendan Lambe,417786644,Eddie Collins,2,1,1
319057545,Brendan Lambe,430602171,Steve Morgan,2,1,1
319057545,Brendan Lambe,495939788,Tyrone Davis,2,2,0
319057545,Brendan Lambe,501266206,David Fox,2,1,1
319057545,Brendan Lambe,567624732,Dave Brampton,2,1,1
319057545,Brendan Lambe,661923191,Steve Gardner,2,1,1
319057545,Brendan Lambe,713064363,John Trory,2,1,1
319057545,Brendan Lambe,746406369,Loz O'Keefe,2,1,1
319057545,Brendan Lambe,773216781,Sean Payne,2,1,1
319057545,Brendan Lambe,833156731,Jez Saunders,2,1,1
319057545,Brendan Lambe,845758589,Charlie James,2,1,1
319057545,Brendan Lambe,929636592,Danny Wilson,2,1,1
319057545,Brendan Lambe,943667183,John Stone,2,1,1
319057545,Brendan Lambe,971308746,Clive Harman,2,1,1
323907964,Russ Hughes,136,Dave Bonwick,2,2,0
323907964,Russ Hughes,365,Dan Buckwell,2,2,0
323907964,Russ Hughes,26970170,Kai Michael,2,2,0
323907964,Russ Hughes,60575249,Ash Thurmer,2,2,0
323907964,Russ Hughes,90176364,David Page,2,2,0
323907964,Russ Hughes,356397577,David Morgan,2,1,1
323907964,Russ Hughes,390364577,Mark Bright,2,1,1
323907964,Russ Hughes,426009127,Bav Patel,2,1,1
323907964,Russ Hughes,428102632,Anthony Flynn,2,1,1
323907964,Russ Hughes,654650203,Alan O'Sullivan,2,1,1
323907964,Russ Hughes,662568995,Rob Wykes,2,1,1
323907964,Russ Hughes,752709358,Chris Mason,2,1,1
323907964,Russ Hughes,764177688,Barry Martin,2,1,1
323907964,Russ Hughes,825399596,Pat Adams,2,1,1
323907964,Russ Hughes,865803068,Dave Jones,2,1,1
323907964,Russ Hughes,963958265,Rodney Moogan,2,2,0
326225304,Ian Raeburn,279543944,Peter Maurice,2,2,0
326225304,Ian Raeburn,351143642,Michael Palmer,2,2,0
326225304,Ian Raeburn,713064363,John Trory,2,2,0
326225304,Ian Raeburn,820231590,Alan Rook,2,1,1
326225304,Ian Raeburn,845758589,Charlie James,2,2,0
326342962,Geoff Randall,124523642,Tom Hayes,2,2,0
326342962,Geoff Randall,225850882,John McLellan,2,2,0
326342962,Geoff Randall,428102632,Anthony Flynn,2,1,1
326342962,Geoff Randall,463709832,Danny Wong,2,2,0
326342962,Geoff Randall,608140548,David Gillingham,2,1,1
326342962,Geoff Randall,649307517,Wes Kingham,2,2,0
326342962,Geoff Randall,662568995,Rob Wykes,2,1,1
326342962,Geoff Randall,669385277,Steve Towler,2,2,0
326342962,Geoff Randall,764177688,Barry Martin,2,1,1
326342962,Geoff Randall,948504778,Jon Fordham,2,1,1
326342962,Geoff Randall,963206772,Dean Moore,2,1,1
326342962,Geoff Randall,974385564,Danny Booker,2,1,1
327948141,Ross Etheridge,279543944,Peter Maurice,2,2,0
327948141,Ross Etheridge,394906196,Mick Mabbitt,2,2,0
327948141,Ross Etheridge,429738563,Adam Buckingham,2,1,1
327948141,Ross Etheridge,501266206,David Fox,2,2,0
327948141,Ross Etheridge,612265840,Paul Honeysett,2,1,1
327948141,Ross Etheridge,719124015,Tony Power,2,1,1
327948141,Ross Etheridge,728690686,Rick Rothschild,2,1,1
327948141,Ross Etheridge,809647573,John Taylor,2,1,1
327948141,Ross Etheridge,833156731,Jez Saunders,2,2,0
327948141,Ross Etheridge,844676925,Kieran Williams,2,2,0
327948141,Ross Etheridge,901024459,Paul Charman,2,2,0
327948141,Ross Etheridge,963206772,Dean Moore,2,1,1
341869673,Nigel Stilwell,26970170,Kai Michael,2,2,0
341869673,Nigel Stilwell,426009127,Bav Patel,2,1,1
341869673,Nigel Stilwell,480772114,Kevin Ward,2,2,0
341869673,Nigel Stilwell,717256135,Trevor Pickard,2,2,0
341869673,Nigel Stilwell,752709358,Chris Mason,2,1,1
341869673,Nigel Stilwell,809568302,Mark Johnson,2,1,1
341869673,Nigel Stilwell,963958265,Rodney Moogan,2,1,1
345558874,Zack Richardson,5820499,Paul Bartlett,2,2,0
345558874,Zack Richardson,384960657,Dave Lewney,2,2,0
345558874,Zack Richardson,428102632,Anthony Flynn,2,2,0
345558874,Zack Richardson,444639447,Andy Wong,2,2,0
345558874,Zack Richardson,646410961,Paul Scorer,2,2,0
345558874,Zack Richardson,670256222,Connor Anderson,2,1,1
345558874,Zack Richardson,754250007,Freddie Blunden,2,2,0
345558874,Zack Richardson,794630189,Mark Coles,2,1,1
345558874,Zack Richardson,927588200,Tokki Yamaguchi,2,1,1
349269645,Barry Thornton,415524562,Dave King,2,1,1
349269645,Barry Thornton,598117191,Jerome Fowler,2,2,0
349269645,Barry Thornton,704007508,Alan Muir,2,2,0
349269645,Barry Thornton,713064363,John Trory,2,1,1
349269645,Barry Thornton,845758589,Charlie James,2,1,1
349269645,Barry Thornton,901024459,Paul Charman,2,1,1
349269645,Barry Thornton,929636592,Danny Wilson,2,2,0
349269645,Barry Thornton,953512654,Les Berry,2,1,1
349269645,Barry Thornton,970786910,Kevin Sorrell,2,1,1
349269645,Barry Thornton,978156264,Bob Paine,2,2,0
351143642,Michael Palmer,153,Tony Leach,2,2,0
351143642,Michael Palmer,41461520,Luke Pooley,2,2,0
351143642,Michael Palmer,291816585,Jim Somers,2,2,0
351143642,Michael Palmer,293577764,Dave Crosskey,2,2,0
351143642,Michael Palmer,392533233,Jack Wright,2,1,1
351143642,Michael Palmer,495939788,Tyrone Davis,2,2,0
351143642,Michael Palmer,506320151,Frank Taylor,2,2,0
351143642,Michael Palmer,535728699,Fred Cooper,2,1,1
351143642,Michael Palmer,567316488,Lee Millyard,2,1,1
351143642,Michael Palmer,688778183,Dean Paice,2,1,1
351143642,Michael Palmer,719124015,Tony Power,2,1,1
351143642,Michael Palmer,745152759,Kevin Jewell,2,2,0
351143642,Michael Palmer,820231590,Alan Rook,2,2,0
351143642,Michael Palmer,845758589,Charlie James,2,1,1
351143642,Michael Palmer,866506631,Mark Smith,2,1,1
351143642,Michael Palmer,922772801,Nick Buonanno,2,1,1
351143642,Michael Palmer,966905561,Tony Dade,2,1,1
351143642,Michael Palmer,978156264,Bob Paine,2,2,0
356397577,David Morgan,34787509,Dave McCarthy,2,2,0
356397577,David Morgan,341869673,Nigel Stilwell,2,2,0
356397577,David Morgan,428102632,Anthony Flynn,2,2,0
356397577,David Morgan,444639447,Andy Wong,2,1,1
356397577,David Morgan,561171273,Andy Norman,2,2,0
356397577,David Morgan,666735933,Mike Collier,2,1,1
356397577,David Morgan,670256222,Connor Anderson,2,2,0
356397577,David Morgan,680442672,Scott Lawson,2,2,0
356397577,David Morgan,717256135,Trevor Pickard,2,2,0
356397577,David Morgan,797962517,Dave Lewis,2,1,1
356397577,David Morgan,802242736,Steve Hughes,2,2,0
356397577,David Morgan,809568302,Mark Johnson,2,2,0
356397577,David Morgan,963958265,Rodney Moogan,2,2,0
360777082,Mark Bishop,247,Mick Justice,2,2,0
360777082,Mark Bishop,32061370,Toby Prince-Iles,2,2,0
360777082,Mark Bishop,287057630,Darren Hearn,2,2,0
360777082,Mark Bishop,291816585,Jim Somers,2,2,0
360777082,Mark Bishop,351143642,Michael Palmer,2,2,0
360777082,Mark Bishop,410854609,Dave Lowe,2,2,0
360777082,Mark Bishop,493830161,Luke Strevens,2,1,1
360777082,Mark Bishop,728690686,Rick Rothschild,2,2,0
360777082,Mark Bishop,807603289,Kevin Gardner,2,2,0
360777082,Mark Bishop,867613624,Ian Dunhill,2,2,0
360777082,Mark Bishop,889234854,Paul Smith,2,1,1
360777082,Mark Bishop,929636592,Danny Wilson,2,2,0
360777082,Mark Bishop,936624299,Peter Gallant,2,2,0
360777082,Mark Bishop,966905561,Tony Dade,2,2,0
360777082,Mark Bishop,970786910,Kevin Sorrell,2,1,1
363402934,Rod Phillippe,495939788,Tyrone Davis,2,2,0
363402934,Rod Phillippe,978156264,Bob Paine,2,2,0
364867274,Dave Lucking,301,Terry Grant,2,2,0
364867274,Dave Lucking,386517733,Ady Halley,2,2,0
364867274,Dave Lucking,428102632,Anthony Flynn,2,1,1
364867274,Dave Lucking,463709832,Danny Wong,2,1,1
364867274,Dave Lucking,836895047,Ian McKay,2,1,1
382970973,Paul Shaw,121,Mike Barnett,2,2,0
382970973,Paul Shaw,181,Dave Roughley,2,2,0
382970973,Paul Shaw,293577764,Dave Crosskey,2,2,0
382970973,Paul Shaw,464085958,Gerwyn Bowen,2,1,1
382970973,Paul Shaw,574248035,Tony Mulhern,2,2,0
382970973,Paul Shaw,809647573,John Taylor,2,2,0
382970973,Paul Shaw,873916947,Geoff Akehurst,2,2,0
382970973,Paul Shaw,884374645,Wayne Iddon,2,1,1
382970973,Paul Shaw,899206834,Jez Downs,2,2,0
382970973,Paul Shaw,915035871,Kevin Graysmark,2,2,0
384960657,Dave Lewney,1,Tim Dawes,2,2,0
384960657,Dave Lewney,137,Ricky Beecham,2,2,0
384960657,Dave Lewney,192463126,Gerry Lindsey,2,2,0
384960657,Dave Lewney,323907964,Russ Hughes,2,2,0
384960657,Dave Lewney,444639447,Andy Wong,2,1,1
384960657,Dave Lewney,490170224,Jamie Matthews,2,1,1
384960657,Dave Lewney,579164381,Danny Cattell,2,2,0
384960657,Dave Lewney,646410961,Paul Scorer,2,1,1
384960657,Dave Lewney,662568995,Rob Wykes,2,1,1
384960657,Dave Lewney,666735933,Mike Collier,2,1,1
384960657,Dave Lewney,732321233,Nathan Brooks,2,1,1
384960657,Dave Lewney,837429850,Paul Beecham,2,1,1
384960657,Dave Lewney,850059806,Heng Wong,2,2,0
386517733,Ady Halley,78,Kevin Baker,2,2,0
386517733,Ady Halley,92,Dale Thomas,2,2,0
386517733,Ady Halley,98,Tony Collins,2,2,0
386517733,Ady Halley,288,Pete Elliott,2,2,0
386517733,Ady Halley,374,Lloyd Saunders,2,2,0
386517733,Ady Halley,144181207,Jack Yates,2,2,0
386517733,Ady Halley,223983583,Carl Wentworth,2,2,0
386517733,Ady Halley,426236650,Dave Parrott,2,2,0
386517733,Ady Halley,510918620,Robert Bowden,2,1,1
386517733,Ady Halley,535728699,Fred Cooper,2,1,1
386517733,Ady Halley,598846718,Ben Sorrell,2,1,1
386517733,Ady Halley,613893140,Matt Warner,2,1,1
386517733,Ady Halley,657320021,Brett Strevens,2,1,1
386517733,Ady Halley,688778183,Dean Paice,2,1,1
386517733,Ady Halley,737709582,Tony Browne,2,1,1
386517733,Ady Halley,833156731,Jez Saunders,2,1,1
386517733,Ady Halley,845537273,Dave Gridley,2,1,1
386517733,Ady Halley,980908578,Jake Whatman,2,2,0
390364577,Mark Bright,341869673,Nigel Stilwell,2,2,0
390364577,Mark Bright,426009127,Bav Patel,2,1,1
390364577,Mark Bright,662568995,Rob Wykes,2,2,0
390364577,Mark Bright,670256222,Connor Anderson,2,1,1
390364577,Mark Bright,957784480,Harry Banks,2,1,1
392533233,Jack Wright,80,Dave Wells,2,2,0
392533233,Jack Wright,247,Mick Justice,2,2,0
392533233,Jack Wright,444350794,Richard Freeman,2,1,1
392533233,Jack Wright,546362444,Anthony Trory,2,1,1
392533233,Jack Wright,820231590,Alan Rook,2,2,0
392533233,Jack Wright,858283721,Dave Dunstall,2,1,1
394906196,Mick Mabbitt,316,Paul Redgate,2,2,0
394906196,Mick Mabbitt,202090738,Alan Head,2,2,0
394906196,Mick Mabbitt,279543944,Peter Maurice,2,2,0
394906196,Mick Mabbitt,291816585,Jim Somers,2,2,0
394906196,Mick Mabbitt,319057545,Brendan Lambe,2,2,0
394906196,Mick Mabbitt,386517733,Ady Halley,2,2,0
394906196,Mick Mabbitt,402257815,Jim Cumming,2,1,1
394906196,Mick Mabbitt,480154054,Jim Dunstall,2,1,1
394906196,Mick Mabbitt,809984729,Neil Scutt,2,1,1
394906196,Mick Mabbitt,839313888,Kevin Chrysanthou,2,1,1
401846353,Frank McHugh,496,Lucas Flux,2,2,0
401846353,Frank McHugh,630748783,Darren Hills,2,2,0
401846353,Frank McHugh,978156264,Bob Paine,2,1,1
402257815,Jim Cumming,535728699,Fred Cooper,2,2,0
402257815,Jim Cumming,612265840,Paul Honeysett,2,2,0
402257815,Jim Cumming,809984729,Neil Scutt,2,1,1
402257815,Jim Cumming,845758589,Charlie James,2,2,0
402257815,Jim Cumming,884374645,Wayne Iddon,2,2,0
409212679,Mark Chapman,239,Mick Lucas,2,2,0
409212679,Mark Chapman,445,Lachlan Monroe,2,2,0
409212679,Mark Chapman,448,Adam Bradshaw,2,2,0
409212679,Mark Chapman,32061370,Toby Prince-Iles,2,2,0
409212679,Mark Chapman,279543944,Peter Maurice,2,2,0
409212679,Mark Chapman,291816585,Jim Somers,2,2,0
409212679,Mark Chapman,392533233,Jack Wright,2,2,0
409212679,Mark Chapman,444350794,Richard Freeman,2,2,0
409212679,Mark Chapman,484159049,Tommy Wright,2,1,1
409212679,Mark Chapman,506581042,Glen Dartnell,2,1,1
409212679,Mark Chapman,598117191,Jerome Fowler,2,1,1
409212679,Mark Chapman,713064363,John Trory,2,1,1
409212679,Mark Chapman,724342701,Nigel Lilley,2,2,0
409212679,Mark Chapman,737709582,Tony Browne,2,1,1
409212679,Mark Chapman,809647573,John Taylor,2,2,0
409212679,Mark Chapman,809984729,Neil Scutt,2,1,1
409212679,Mark Chapman,815023707,David Senior,2,2,0
409212679,Mark Chapman,833156731,Jez Saunders,2,1,1
409212679,Mark Chapman,899206834,Jez Downs,2,1,1
409212679,Mark Chapman,943667183,John Stone,2,2,0
409212679,Mark Chapman,978156264,Bob Paine,2,2,0
410854609,Dave Lowe,97,Shaun Winsor,2,2,0
410854609,Dave Lowe,285,Pete Davie,2,2,0
410854609,Dave Lowe,292,Jim Mulcahey,2,2,0
410854609,Dave Lowe,535728699,Fred Cooper,2,2,0
410854609,Dave Lowe,815023707,David Senior,2,1,1
410854609,Dave Lowe,884374645,Wayne Iddon,2,1,1
411473516,Ray Canham,183,Simon Alexander,2,2,0
411473516,Ray Canham,279543944,Peter Maurice,2,2,0
411473516,Ray Canham,451309825,Maurice Wickens,2,1,1
411473516,Ray Canham,455401154,Kai Ellis,2,2,0
411473516,Ray Canham,498330760,Mo Collins,2,2,0
411473516,Ray Canham,529382351,Greg Foat,2,2,0
411473516,Ray Canham,598117191,Jerome Fowler,2,1,1
411473516,Ray Canham,612265840,Paul Honeysett,2,1,1
411473516,Ray Canham,654650203,Alan O'Sullivan,2,1,1
411473516,Ray Canham,713064363,John Trory,2,2,0
411473516,Ray Canham,788605510,Mark Rose,2,1,1
411473516,Ray Canham,809647573,John Taylor,2,1,1
411473516,Ray Canham,867613624,Ian Dunhill,2,1,1
411473516,Ray Canham,878576746,Jon Hall,2,1,1
412256116,Andy Sutton,76,David Rea,2,2,0
412256116,Andy Sutton,157,Stewart Swanton,2,2,0
412256116,Andy Sutton,300,Graham Smart,2,2,0
412256116,Andy Sutton,321,Mick Ingram,2,2,0
412256116,Andy Sutton,402257815,Jim Cumming,2,2,0
412256116,Andy Sutton,420230435,Jack Fielder,2,1,1
412256116,Andy Sutton,423038309,Ian Fennell,2,1,1
412256116,Andy Sutton,506320151,Frank Taylor,2,2,0
412256116,Andy Sutton,629014363,Lee Shepherd,2,1,1
412256116,Andy Sutton,713064363,John Trory,2,2,0
412256116,Andy Sutton,873916947,Geoff Akehurst,2,2,0
412256116,Andy Sutton,878576746,Jon Hall,2,2,0
412256116,Andy Sutton,880982797,Ray Hunter,2,1,1
412256116,Andy Sutton,889234854,Paul Smith,2,1,1
412256116,Andy Sutton,901024459,Paul Charman,2,1,1
415524562,Dave King,316,Paul Redgate,2,2,0
415524562,Dave King,480154054,Jim Dunstall,2,2,0
415524562,Dave King,556095121,Tom Wright,2,1,1
415524562,Dave King,573567936,Steve Marriott,2,1,1
415524562,Dave King,845758589,Charlie James,2,2,0
417786644,Eddie Collins,56252722,Dave Pither,2,2,0
417786644,Eddie Collins,612265840,Paul Honeysett,2,2,0
417786644,Eddie Collins,943667183,John Stone,2,1,1
417786644,Eddie Collins,978156264,Bob Paine,2,1,1
420230435,Jack Fielder,38,Rob Bowden,2,2,0
420230435,Jack Fielder,464085958,Gerwyn Bowen,2,2,0
420230435,Jack Fielder,510918620,Robert Bowden,2,2,0
420230435,Jack Fielder,573567936,Steve Marriott,2,2,0
420230435,Jack Fielder,669385277,Steve Towler,2,2,0
420230435,Jack Fielder,670034050,John Muzio,2,2,0
420230435,Jack Fielder,713064363,John Trory,2,2,0
420230435,Jack Fielder,899206834,Jez Downs,2,2,0
423038309,Ian Fennell,121,Mike Barnett,2,2,0
423038309,Ian Fennell,146404254,Randall Griffiths,2,2,0
423038309,Ian Fennell,171346729,Des Heasman,2,2,0
423038309,Ian Fennell,287057630,Darren Hearn,2,2,0
423038309,Ian Fennell,319057545,Brendan Lambe,2,2,0
423038309,Ian Fennell,574248035,Tony Mulhern,2,2,0
423038309,Ian Fennell,732415457,Barry Hall,2,2,0
423038309,Ian Fennell,889234854,Paul Smith,2,1,1
423038309,Ian Fennell,901024459,Paul Charman,2,2,0
426009127,Bav Patel,5820499,Paul Bartlett,2,2,0
426009127,Bav Patel,124523642,Tom Hayes,2,2,0
426009127,Bav Patel,192463126,Gerry Lindsey,2,2,0
426009127,Bav Patel,275738778,John Da Silva,2,2,0
426009127,Bav Patel,384960657,Dave Lewney,2,2,0
426009127,Bav Patel,717256135,Trevor Pickard,2,2,0
426009127,Bav Patel,802242736,Steve Hughes,2,1,1
426009127,Bav Patel,974385564,Danny Booker,2,2,0
426236650,Dave Parrott,845758589,Charlie James,2,1,1
428102632,Anthony Flynn,144293731,Simon Parry,2,2,0
428102632,Anthony Flynn,444639447,Andy Wong,2,1,1
428102632,Anthony Flynn,654650203,Alan O'Sullivan,2,2,0
428102632,Anthony Flynn,732321233,Nathan Brooks,2,2,0
428102632,Anthony Flynn,809647573,John Taylor,2,2,0
428102632,Anthony Flynn,825399596,Pat Adams,2,1,1
428102632,Anthony Flynn,837429850,Paul Beecham,2,2,0
428102632,Anthony Flynn,850059806,Heng Wong,2,1,1
429738563,Adam Buckingham,394906196,Mick Mabbitt,2,2,0
430890681,Malcolm Cooper,84,Gavin McCubbin,2,2,0
430890681,Malcolm Cooper,384,Bryan Beck,2,2,0
430890681,Malcolm Cooper,291816585,Jim Somers,2,2,0
430890681,Malcolm Cooper,501266206,David Fox,2,2,0
430890681,Malcolm Cooper,504949622,Jimmy Moseley,2,1,1
430890681,Malcolm Cooper,506320151,Frank Taylor,2,2,0
430890681,Malcolm Cooper,646614924,Norman Moye,2,1,1
430890681,Malcolm Cooper,649240057,Mike Childs,2,2,0
430890681,Malcolm Cooper,844676925,Kieran Williams,2,2,0
430890681,Malcolm Cooper,910809545,Blake Harman,2,1,1
436708540,Bob Henley,301,Terry Grant,2,2,0
436708540,Bob Henley,321,Mick Ingram,2,2,0
436708540,Bob Henley,382970973,Paul Shaw,2,2,0
436708540,Bob Henley,654650203,Alan O'Sullivan,2,1,1
436708540,Bob Henley,673242409,Alan Colvin,2,2,0
436708540,Bob Henley,721321839,Matt Peake,2,1,1
436708540,Bob Henley,733453947,Phil Canham,2,1,1
436708540,Bob Henley,901024459,Paul Charman,2,1,1
444339215,Steve Richards,172646809,Robin Powell,2,2,0
444339215,Steve Richards,279543944,Peter Maurice,2,2,0
444339215,Steve Richards,529382351,Greg Foat,2,1,1
444339215,Steve Richards,657320021,Brett Strevens,2,1,1
444339215,Steve Richards,804381932,Ryan Harman,2,2,0
444350794,Richard Freeman,501266206,David Fox,2,2,0
444350794,Richard Freeman,529382351,Greg Foat,2,2,0
444350794,Richard Freeman,535728699,Fred Cooper,2,2,0
444350794,Richard Freeman,670034050,John Muzio,2,2,0
444350794,Richard Freeman,732415457,Barry Hall,2,1,1
444350794,Richard Freeman,809647573,John Taylor,2,1,1
444350794,Richard Freeman,809984729,Neil Scutt,2,2,0
444350794,Richard Freeman,845758589,Charlie James,2,2,0
444350794,Richard Freeman,922772801,Nick Buonanno,2,1,1
444639447,Andy Wong,1,Tim Dawes,2,2,0
444639447,Andy Wong,837429850,Paul Beecham,2,1,1
444639447,Andy Wong,957784480,Harry Banks,2,1,1
449331249,Dan Tanner,831214643,Tony Shipley,2,1,1
449331249,Dan Tanner,978156264,Bob Paine,2,2,0
451309825,Maurice Wickens,733453947,Phil Canham,2,1,1
451309825,Maurice Wickens,971308746,Clive Harman,2,1,1
455401154,Kai Ellis,144776055,Brian Wilkes,2,2,0
455401154,Kai Ellis,213264678,Martin Hall,2,2,0
455401154,Kai Ellis,351143642,Michael Palmer,2,2,0
455401154,Kai Ellis,463709832,Danny Wong,2,1,1
455401154,Kai Ellis,484159049,Tommy Wright,2,2,0
455401154,Kai Ellis,800114325,Roger Whiteley,2,2,0
455401154,Kai Ellis,970786910,Kevin Sorrell,2,1,1
463709832,Danny Wong,61,Paul Gander,2,2,0
463709832,Danny Wong,279543944,Peter Maurice,2,2,0
463709832,Danny Wong,327948141,Ross Etheridge,2,2,0
463709832,Danny Wong,484159049,Tommy Wright,2,1,1
463709832,Danny Wong,529382351,Greg Foat,2,2,0
463709832,Danny Wong,641692362,Bob Taylor,2,1,1
463709832,Danny Wong,649307517,Wes Kingham,2,2,0
463709832,Danny Wong,670034050,John Muzio,2,2,0
463709832,Danny Wong,719124015,Tony Power,2,1,1
463709832,Danny Wong,721321839,Matt Peake,2,2,0
463709832,Danny Wong,954080507,Sam Corsby,2,2,0
463709832,Danny Wong,957784480,Harry Banks,2,1,1
463709832,Danny Wong,963206772,Dean Moore,2,2,0
464085958,Gerwyn Bowen,183,Simon Alexander,2,2,0
464085958,Gerwyn Bowen,202,Bob Firth,2,2,0
464085958,Gerwyn Bowen,732415457,Barry Hall,2,1,1
464085958,Gerwyn Bowen,733453947,Phil Canham,2,1,1
464085958,Gerwyn Bowen,954080507,Sam Corsby,2,1,1
479705187,Keith McQueen,239,Mick Lucas,2,2,0
479705187,Keith McQueen,281,Bob Rumble,2,2,0
480154054,Jim Dunstall,649240057,Mike Childs,2,1,1
480154054,Jim Dunstall,873916947,Geoff Akehurst,2,1,1
480154054,Jim Dunstall,971308746,Clive Harman,2,1,1
480154054,Jim Dunstall,978156264,Bob Paine,2,1,1
480772114,Kevin Ward,60575249,Ash Thurmer,2,2,0
480772114,Kevin Ward,271464632,Paul Phillips,2,2,0
480772114,Kevin Ward,717256135,Trevor Pickard,2,2,0
484159049,Tommy Wright,515,Simon Mackenzie,2,2,0
484159049,Tommy Wright,533,Trevor Vine,2,2,0
484159049,Tommy Wright,501266206,David Fox,2,2,0
484159049,Tommy Wright,670034050,John Muzio,2,1,1
484159049,Tommy Wright,721321839,Matt Peake,2,1,1
484159049,Tommy Wright,736672590,Dean Perry,2,1,1
484159049,Tommy Wright,747966869,Richard Morgan,2,2,0
484159049,Tommy Wright,815023707,David Senior,2,2,0
484159049,Tommy Wright,880982797,Ray Hunter,2,2,0
484159049,Tommy Wright,910809545,Blake Harman,2,2,0
484159049,Tommy Wright,943667183,John Stone,2,2,0
484159049,Tommy Wright,966905561,Tony Dade,2,1,1
484159049,Tommy Wright,978156264,Bob Paine,2,2,0
490170224,Jamie Matthews,49,Daniel James,2,2,0
490170224,Jamie Matthews,284,Ray Bradley,2,2,0
490170224,Jamie Matthews,493,M. Holmes,2,2,0
490170224,Jamie Matthews,114184042,Ian Smith,2,2,0
490170224,Jamie Matthews,204951513,Mike Holding,2,2,0
490170224,Jamie Matthews,246154671,Alan Gunn,2,2,0
490170224,Jamie Matthews,319057545,Brendan Lambe,2,2,0
490170224,Jamie Matthews,327948141,Ross Etheridge,2,2,0
490170224,Jamie Matthews,613893140,Matt Warner,2,2,0
490170224,Jamie Matthews,713064363,John Trory,2,2,0
490170224,Jamie Matthews,719124015,Tony Power,2,2,0
490170224,Jamie Matthews,736672590,Dean Perry,2,1,1
490170224,Jamie Matthews,815023707,David Senior,2,2,0
490170224,Jamie Matthews,844676925,Kieran Williams,2,1,1
490170224,Jamie Matthews,848997254,Tom Parker,2,1,1
490170224,Jamie Matthews,878576746,Jon Hall,2,1,1
490170224,Jamie Matthews,922772801,Nick Buonanno,2,1,1
490170224,Jamie Matthews,948504778,Jon Fordham,2,2,0
490170224,Jamie Matthews,968651401,Ryan Grover,2,2,0
490170224,Jamie Matthews,974385564,Danny Booker,2,1,1
493830161,Luke Strevens,271464632,Paul Phillips,2,2,0
493830161,Luke Strevens,349269645,Barry Thornton,2,2,0
493830161,Luke Strevens,484159049,Tommy Wright,2,2,0
493830161,Luke Strevens,598117191,Jerome Fowler,2,2,0
493830161,Luke Strevens,613893140,Matt Warner,2,1,1
493830161,Luke Strevens,719124015,Tony Power,2,2,0
493830161,Luke Strevens,800114325,Roger Whiteley,2,1,1
493830161,Luke Strevens,809984729,Neil Scutt,2,2,0
493830161,Luke Strevens,833156731,Jez Saunders,2,2,0
493830161,Luke Strevens,963206772,Dean Moore,2,1,1
495939788,Tyrone Davis,820231590,Alan Rook,2,1,1
498330760,Mo Collins,284,Ray Bradley,2,2,0
498330760,Mo Collins,501266206,David Fox,2,1,1
498330760,Mo Collins,649240057,Mike Childs,2,1,1
498330760,Mo Collins,733453947,Phil Canham,2,1,1
498330760,Mo Collins,936624299,Peter Gallant,2,1,1
498330760,Mo Collins,966905561,Tony Dade,2,1,1
501266206,David Fox,613893140,Matt Warner,2,1,1
501266206,David Fox,669385277,Steve Towler,2,1,1
501266206,David Fox,809984729,Neil Scutt,2,1,1
501266206,David Fox,831214643,Tony Shipley,2,1,1
501266206,David Fox,844676925,Kieran Williams,2,1,1
501266206,David Fox,889234854,Paul Smith,2,1,1
501266206,David Fox,978156264,Bob Paine,2,2,0
506320151,Frank Taylor,153,Tony Leach,2,2,0
506320151,Frank Taylor,321,Mick Ingram,2,2,0
506320151,Frank Taylor,213264678,Martin Hall,2,2,0
506320151,Frank Taylor,411473516,Ray Canham,2,2,0
506320151,Frank Taylor,674307680,Neil McCafferty,2,1,1
506320151,Frank Taylor,833156731,Jez Saunders,2,1,1
506320151,Frank Taylor,866506631,Mark Smith,2,1,1
506320151,Frank Taylor,901024459,Paul Charman,2,2,0
506320151,Frank Taylor,970786910,Kevin Sorrell,2,1,1
506581042,Glen Dartnell,121263797,Jim Pelling,2,2,0
506581042,Glen Dartnell,124523642,Tom Hayes,2,2,0
506581042,Glen Dartnell,319057545,Brendan Lambe,2,2,0
506581042,Glen Dartnell,326342962,Geoff Randall,2,2,0
506581042,Glen Dartnell,612265840,Paul Honeysett,2,2,0
506581042,Glen Dartnell,688252012,Sean Cooper,2,2,0
506581042,Glen Dartnell,752709358,Chris Mason,2,1,1
506581042,Glen Dartnell,754250007,Freddie Blunden,2,1,1
506581042,Glen Dartnell,797962517,Dave Lewis,2,1,1
506581042,Glen Dartnell,954297832,Pav Sareen,2,2,0
510918620,Robert Bowden,202,Bob Firth,2,2,0
510918620,Robert Bowden,288,Pete Elliott,2,2,0
510918620,Robert Bowden,573567936,Steve Marriott,2,2,0
510918620,Robert Bowden,612265840,Paul Honeysett,2,1,1
510918620,Robert Bowden,670034050,John Muzio,2,1,1
515177310,James Da Costa,852327692,Andy Fletcher,2,2,0
515177310,James Da Costa,963206772,Dean Moore,2,2,0
515186402,Ben Evans,6,Dan Stirling,2,2,0
515186402,Ben Evans,16,Mick Beck,2,2,0
515186402,Ben Evans,326,Stefan Chandler,2,2,0
515186402,Ben Evans,732321233,Nathan Brooks,2,2,0
515186402,Ben Evans,754250007,Freddie Blunden,2,2,0
515186402,Ben Evans,797962517,Dave Lewis,2,1,1
515186402,Ben Evans,802242736,Steve Hughes,2,2,0
515186402,Ben Evans,837429850,Paul Beecham,2,2,0
515186402,Ben Evans,927588200,Tokki Yamaguchi,2,1,1
515186402,Ben Evans,947143243,Chris Davis,2,1,1
523395206,Jamie Lashmar,222,John Newnhan,2,2,0
523395206,Jamie Lashmar,56252722,Dave Pither,2,2,0
523395206,Jamie Lashmar,278731588,Lester Grice,2,2,0
523395206,Jamie Lashmar,326342962,Geoff Randall,2,2,0
523395206,Jamie Lashmar,506581042,Glen Dartnell,2,2,0
523395206,Jamie Lashmar,598846718,Ben Sorrell,2,2,0
523395206,Jamie Lashmar,764177688,Barry Martin,2,1,1
523395206,Jamie Lashmar,797962517,Dave Lewis,2,2,0
523395206,Jamie Lashmar,809984729,Neil Scutt,2,2,0
523395206,Jamie Lashmar,948504778,Jon Fordham,2,2,0
523395206,Jamie Lashmar,954297832,Pav Sareen,2,2,0
523395206,Jamie Lashmar,978156264,Bob Paine,2,2,0
529382351,Greg Foat,417786644,Eddie Collins,2,2,0
529382351,Greg Foat,449331249,Dan Tanner,2,2,0
529382351,Greg Foat,495939788,Tyrone Davis,2,2,0
529382351,Greg Foat,535728699,Fred Cooper,2,1,1
529382351,Greg Foat,688252012,Sean Cooper,2,1,1
529382351,Greg Foat,809984729,Neil Scutt,2,1,1
529382351,Greg Foat,820231590,Alan Rook,2,2,0
529382351,Greg Foat,845758589,Charlie James,2,1,1
529382351,Greg Foat,970786910,Kevin Sorrell,2,1,1
535728699,Fred Cooper,417786644,Eddie Collins,2,2,0
535728699,Fred Cooper,426236650,Dave Parrott,2,2,0
535728699,Fred Cooper,501266206,David Fox,2,2,0
535728699,Fred Cooper,550273589,George Warner,2,2,0
535728699,Fred Cooper,556095121,Tom Wright,2,2,0
535728699,Fred Cooper,612265840,Paul Honeysett,2,2,0
535728699,Fred Cooper,670870044,David Flanagan,2,1,1
535728699,Fred Cooper,745152759,Kevin Jewell,2,1,1
535728699,Fred Cooper,833156731,Jez Saunders,2,2,0
535728699,Fred Cooper,866506631,Mark Smith,2,1,1
535728699,Fred Cooper,873916947,Geoff Akehurst,2,2,0
535728699,Fred Cooper,966905561,Tony Dade,2,2,0
535728699,Fred Cooper,971308746,Clive Harman,2,2,0
537640521,Ian Stoner,172899919,Derek Dale,2,2,0
537640521,Ian Stoner,183400466,David Wright,2,2,0
537640521,Ian Stoner,410854609,Dave Lowe,2,2,0
537640521,Ian Stoner,598846718,Ben Sorrell,2,1,1
537640521,Ian Stoner,612265840,Paul Honeysett,2,2,0
537640521,Ian Stoner,688252012,Sean Cooper,2,2,0
537640521,Ian Stoner,713064363,John Trory,2,1,1
537640521,Ian Stoner,724342701,Nigel Lilley,2,1,1
537640521,Ian Stoner,728690686,Rick Rothschild,2,1,1
537640521,Ian Stoner,733453947,Phil Canham,2,1,1
537640521,Ian Stoner,745152759,Kevin Jewell,2,1,1
537640521,Ian Stoner,836895047,Ian McKay,2,1,1
537640521,Ian Stoner,910809545,Blake Harman,2,2,0
546362444,Anthony Trory,291198629,Tony Burt,2,2,0
546362444,Anthony Trory,409212679,Mark Chapman,2,2,0
546362444,Anthony Trory,480154054,Jim Dunstall,2,2,0
546362444,Anthony Trory,820231590,Alan Rook,2,1,1
546362444,Anthony Trory,845758589,Charlie James,2,1,1
556095121,Tom Wright,164,Neil Bushell,2,2,0
556095121,Tom Wright,390,Luke Cann,2,2,0
556095121,Tom Wright,101751030,Simon Uddin,2,2,0
556095121,Tom Wright,430890681,Malcolm Cooper,2,2,0
556095121,Tom Wright,704007508,Alan Muir,2,1,1
556095121,Tom Wright,848997254,Tom Parker,2,1,1
560540608,Mark Siddle,669385277,Steve Towler,2,1,1
560540608,Mark Siddle,899206834,Jez Downs,2,1,1
561171273,Andrew Norman,212940364,Wayne Jenkinson,2,2,0
561171273,Andrew Norman,963958265,Rodney Moogan,2,1,1
561171273,Andy Norman,394,Alan Burchell,2,2,0
561171273,Andy Norman,463709832,Danny Wong,2,2,0
561171273,Andy Norman,506581042,Glen Dartnell,2,2,0
561171273,Andy Norman,662568995,Rob Wykes,2,1,1
561171273,Andy Norman,748064029,Paul Hughes,2,2,0
567316488,Lee Millyard,235,Derek Conley,2,2,0
567316488,Lee Millyard,32061370,Toby Prince-Iles,2,2,0
567316488,Lee Millyard,35191252,Nigel Hayward,2,2,0
567316488,Lee Millyard,39289507,Mick Laughlin,2,2,0
567316488,Lee Millyard,287057630,Darren Hearn,2,2,0
567316488,Lee Millyard,394906196,Mick Mabbitt,2,2,0
567316488,Lee Millyard,444350794,Richard Freeman,2,2,0
567316488,Lee Millyard,569369123,Chris King,2,2,0
567316488,Lee Millyard,598117191,Jerome Fowler,2,2,0
567316488,Lee Millyard,719124015,Tony Power,2,1,1
567316488,Lee Millyard,835713833,Olly Stewart,2,1,1
567624732,Dave Brampton,102,Reece Childs,2,2,0
567624732,Dave Brampton,28382047,Steve Harrington,2,2,0
567624732,Dave Brampton,32061370,Toby Prince-Iles,2,2,0
567624732,Dave Brampton,69745818,Ian Bowles,2,2,0
567624732,Dave Brampton,349269645,Barry Thornton,2,2,0
567624732,Dave Brampton,612265840,Paul Honeysett,2,1,1
567624732,Dave Brampton,713064363,John Trory,2,1,1
567624732,Dave Brampton,884374645,Wayne Iddon,2,1,1
573567936,Steve Marriott,182,Brian Welfare,2,2,0
573567936,Steve Marriott,144776055,Brian Wilkes,2,2,0
573567936,Steve Marriott,223983583,Carl Wentworth,2,2,0
573567936,Steve Marriott,449331249,Dan Tanner,2,2,0
573567936,Steve Marriott,579164381,Danny Cattell,2,1,1
573567936,Steve Marriott,649240057,Mike Childs,2,1,1
573567936,Steve Marriott,657320021,Brett Strevens,2,1,1
573567936,Steve Marriott,724342701,Nigel Lilley,2,2,0
573567936,Steve Marriott,804381932,Ryan Harman,2,1,1
573567936,Steve Marriott,815023707,David Senior,2,2,0
573567936,Steve Marriott,858283721,Dave Dunstall,2,1,1
573567936,Steve Marriott,884374645,Wayne Iddon,2,1,1
573567936,Steve Marriott,899206834,Jez Downs,2,2,0
574248035,Tony Mulhern,300,Graham Smart,2,2,0
574248035,Tony Mulhern,321,Mick Ingram,2,2,0
574248035,Tony Mulhern,144776055,Brian Wilkes,2,2,0
574248035,Tony Mulhern,204951513,Mike Holding,2,2,0
574248035,Tony Mulhern,501266206,David Fox,2,2,0
574248035,Tony Mulhern,506320151,Frank Taylor,2,2,0
574248035,Tony Mulhern,629014363,Lee Shepherd,2,1,1
574248035,Tony Mulhern,719124015,Tony Power,2,1,1
574248035,Tony Mulhern,734416600,DON PENALVER,2,1,1
574248035,Tony Mulhern,736672590,Dean Perry,2,1,1
574248035,Tony Mulhern,833156731,Jez Saunders,2,1,1
574248035,Tony Mulhern,848997254,Tom Parker,2,1,1
574248035,Tony Mulhern,949603489,Pete Bennett,2,1,1
579164381,Danny Cattell,16,Mick Beck,2,2,0
579164381,Danny Cattell,177,John Regan,2,2,0
579164381,Danny Cattell,70159035,Peter Rea,2,2,0
579164381,Danny Cattell,114184042,Ian Smith,2,2,0
579164381,Danny Cattell,171346729,Des Heasman,2,2,0
579164381,Danny Cattell,172646809,Robin Powell,2,2,0
579164381,Danny Cattell,231445676,Tony Paice,2,2,0
579164381,Danny Cattell,294944526,Rob Teanby,2,2,0
579164381,Danny Cattell,641692362,Bob Taylor,2,2,0
579164381,Danny Cattell,800114325,Roger Whiteley,2,2,0
579164381,Danny Cattell,858283721,Dave Dunstall,2,1,1
579164381,Danny Cattell,954080507,Sam Corsby,2,2,0
584652998,Harry Stone,820231590,Alan Rook,2,1,1
584652998,Harry Stone,978156264,Bob Paine,2,1,1
588421173,Anish Gokool,278731588,Lester Grice,2,2,0
595079459,Ben Fordham,60575249,Ash Thurmer,2,2,0
597923939,David Lovegrove,41098823,Mikey Booker,2,2,0
597923939,David Lovegrove,623613383,Chris Marsh,2,2,0
597923939,David Lovegrove,788605510,Mark Rose,2,1,1
598117191,Jerome Fowler,144181207,Jack Yates,2,2,0
598117191,Jerome Fowler,529382351,Greg Foat,2,2,0
598117191,Jerome Fowler,910809545,Blake Harman,2,2,0
598117191,Jerome Fowler,951468676,Steve Burchett,2,1,1
598552542,John Colgan,356,Scott Harris,2,2,0
598552542,John Colgan,674307680,Neil McCafferty,2,1,1
598552542,John Colgan,746406369,Loz O'Keefe,2,1,1
598552542,John Colgan,815023707,David Senior,2,2,0
598552542,John Colgan,820231590,Alan Rook,2,1,1
598552542,John Colgan,844676925,Kieran Williams,2,1,1
598552542,John Colgan,929636592,Danny Wilson,2,1,1
598846718,Ben Sorrell,319,John Lojo,2,2,0
598846718,Ben Sorrell,27255501,Tom Lane,2,2,0
598846718,Ben Sorrell,293577764,Dave Crosskey,2,2,0
598846718,Ben Sorrell,677110925,Jake Dunstall,2,2,0
598846718,Ben Sorrell,688252012,Sean Cooper,2,1,1
598846718,Ben Sorrell,713064363,John Trory,2,1,1
598846718,Ben Sorrell,873916947,Geoff Akehurst,2,1,1
598846718,Ben Sorrell,910809545,Blake Harman,2,1,1
598846718,Ben Sorrell,971308746,Clive Harman,2,1,1
600385553,Darren Welfare,16,Mick Beck,2,2,0
600385553,Darren Welfare,89,Mike Atkins,2,2,0
600385553,Darren Welfare,503528426,Larry Maloney,2,2,0
600385553,Darren Welfare,856755662,David Marsh,2,2,0
608140548,David Gillingham,70,Michael Turner-Lee,2,2,0
608140548,David Gillingham,237,Paul Wilson,2,2,0
608140548,David Gillingham,395,Herby Burchell,2,2,0
608140548,David Gillingham,26970170,Kai Michael,2,2,0
608140548,David Gillingham,41098823,Mikey Booker,2,2,0
608140548,David Gillingham,76011459,Kane Harman,2,2,0
608140548,David Gillingham,114184042,Ian Smith,2,2,0
608140548,David Gillingham,204951513,Mike Holding,2,2,0
608140548,David Gillingham,436708540,Bob Henley,2,2,0
608140548,David Gillingham,480772114,Kevin Ward,2,2,0
608140548,David Gillingham,537640521,Ian Stoner,2,2,0
608140548,David Gillingham,733453947,Phil Canham,2,2,0
608140548,David Gillingham,748064029,Paul Hughes,2,2,0
608140548,David Gillingham,773216781,Sean Payne,2,2,0
608140548,David Gillingham,866506631,Mark Smith,2,1,1
608140548,David Gillingham,889234854,Paul Smith,2,2,0
608140548,David Gillingham,974385564,Danny Booker,2,1,1
612265840,Paul Honeysett,386517733,Ady Halley,2,2,0
612265840,Paul Honeysett,479705187,Keith McQueen,2,2,0
612265840,Paul Honeysett,733453947,Phil Canham,2,1,1
612265840,Paul Honeysett,844676925,Kieran Williams,2,1,1
612265840,Paul Honeysett,966905561,Tony Dade,2,2,0
612265840,Paul Honeysett,978156264,Bob Paine,2,1,1
613893140,Matt Warner,69745818,Ian Bowles,2,2,0
613893140,Matt Warner,171346729,Des Heasman,2,2,0
613893140,Matt Warner,183400466,David Wright,2,2,0
613893140,Matt Warner,207592931,(shorty) Gediminas Aleksandravicius,2,2,0
613893140,Matt Warner,287057630,Darren Hearn,2,2,0
613893140,Matt Warner,417786644,Eddie Collins,2,2,0
613893140,Matt Warner,567316488,Lee Millyard,2,2,0
613893140,Matt Warner,598846718,Ben Sorrell,2,2,0
613893140,Matt Warner,676753614,Don James,2,1,1
613893140,Matt Warner,688252012,Sean Cooper,2,2,0
613893140,Matt Warner,688778183,Dean Paice,2,1,1
613893140,Matt Warner,704007508,Alan Muir,2,2,0
613893140,Matt Warner,733453947,Phil Canham,2,1,1
613893140,Matt Warner,968651401,Ryan Grover,2,2,0
617252199,Jim Griffiths,623613383,Chris Marsh,2,1,1
617252199,Jim Griffiths,728690686,Rick Rothschild,2,2,0
617252199,Jim Griffiths,867613624,Ian Dunhill,2,1,1
617751649,Lee Simpson,5,Paul Osiecki,2,2,0
617751649,Lee Simpson,193,Gary Goodman,2,2,0
617751649,Lee Simpson,365,Dan Buckwell,2,2,0
617751649,Lee Simpson,90176364,David Page,2,2,0
617751649,Lee Simpson,147556923,Hong Ming Lee,2,2,0
617751649,Lee Simpson,600385553,Darren Welfare,2,2,0
617751649,Lee Simpson,662568995,Rob Wykes,2,1,1
617751649,Lee Simpson,717256135,Trevor Pickard,2,2,0
617751649,Lee Simpson,732321233,Nathan Brooks,2,2,0
617751649,Lee Simpson,837429850,Paul Beecham,2,2,0
617751649,Lee Simpson,927588200,Tokki Yamaguchi,2,1,1
619390728,Steve Stylianou,5,Paul Osiecki,2,2,0
619390728,Steve Stylianou,22,Tim Shutt,2,2,0
619390728,Steve Stylianou,136,Dave Bonwick,2,2,0
619390728,Steve Stylianou,223,Ollie Stalley,2,2,0
619390728,Steve Stylianou,11133032,Simon Dent,2,2,0
619390728,Steve Stylianou,112887737,Pip Akehurst,2,2,0
619390728,Steve Stylianou,231975313,Danny English,2,2,0
619390728,Steve Stylianou,384960657,Dave Lewney,2,2,0
619390728,Steve Stylianou,732321233,Nathan Brooks,2,1,1
619390728,Steve Stylianou,797962517,Dave Lewis,2,1,1
619390728,Steve Stylianou,927588200,Tokki Yamaguchi,2,1,1
619390728,Steve Stylianou,948504778,Jon Fordham,2,2,0
623613383,Chris Marsh,27255501,Tom Lane,2,2,0
623613383,Chris Marsh,207592931,(shorty) Gediminas Aleksandravicius,2,2,0
623613383,Chris Marsh,394906196,Mick Mabbitt,2,2,0
623613383,Chris Marsh,493830161,Luke Strevens,2,2,0
623613383,Chris Marsh,537640521,Ian Stoner,2,2,0
623613383,Chris Marsh,613889718,Terry Bashford,2,2,0
623613383,Chris Marsh,866506631,Mark Smith,2,1,1
623613383,Chris Marsh,899206834,Jez Downs,2,1,1
629014363,Lee Shepherd,326342962,Geoff Randall,2,2,0
629014363,Lee Shepherd,428102632,Anthony Flynn,2,2,0
629014363,Lee Shepherd,809568302,Mark Johnson,2,1,1
629014363,Lee Shepherd,954080507,Sam Corsby,2,1,1
629014363,Lee Shepherd,963958265,Rodney Moogan,2,2,0
629014363,Lee Shepherd,974385564,Danny Booker,2,1,1
641692362,Bob Taylor,351143642,Michael Palmer,2,2,0
641692362,Bob Taylor,825399596,Pat Adams,2,1,1
641692362,Bob Taylor,947620111,Neil Cutler,2,1,1
646410961,Paul Scorer,96103077,Paul Norris,2,2,0
646410961,Paul Scorer,619390728,Steve Stylianou,2,2,0
646410961,Paul Scorer,703030938,Ollie Thurmer,2,2,0
646410961,Paul Scorer,825399596,Pat Adams,2,2,0
646410961,Paul Scorer,865803068,Dave Jones,2,1,1
646614924,Norman Moye,901024459,Paul Charman,2,1,1
649078882,Richard Barrett,76011459,Kane Harman,2,2,0
649078882,Richard Barrett,304563362,Dan Marchant,2,2,0
649078882,Richard Barrett,556095121,Tom Wright,2,2,0
649078882,Richard Barrett,836895047,Ian McKay,2,1,1
649240057,Mike Childs,280,Terry Slark,2,2,0
649240057,Mike Childs,510,Louie Crosskey,2,2,0
649240057,Mike Childs,514,Tyler Barker,2,2,0
649240057,Mike Childs,943667183,John Stone,2,1,1
649307517,Wes Kingham,873916947,Geoff Akehurst,2,2,0
654650203,Alan O'Sullivan,28382047,Steve Harrington,2,2,0
654650203,Alan O'Sullivan,121263797,Jim Pelling,2,2,0
654650203,Alan O'Sullivan,574248035,Tony Mulhern,2,2,0
654650203,Alan O'Sullivan,688252012,Sean Cooper,2,1,1
654650203,Alan O'Sullivan,736672590,Dean Perry,2,1,1
654650203,Alan O'Sullivan,866506631,Mark Smith,2,1,1
654650203,Alan O'Sullivan,948504778,Jon Fordham,2,1,1
655917217,Terry Mills,732415457,Barry Hall,2,1,1
657320021,Brett Strevens,223983583,Carl Wentworth,2,2,0
657320021,Brett Strevens,880982797,Ray Hunter,2,1,1
657320021,Brett Strevens,953512654,Les Berry,2,1,1
661923191,Steve Gardner,160950731,Locky McCurdy,2,2,0
661923191,Steve Gardner,529382351,Greg Foat,2,2,0
661923191,Steve Gardner,717256135,Trevor Pickard,2,1,1
661923191,Steve Gardner,836895047,Ian McKay,2,1,1
661923191,Steve Gardner,880982797,Ray Hunter,2,1,1
662568995,Rob Wykes,26970170,Kai Michael,2,2,0
662568995,Rob Wykes,266591683,Chris Roche,2,2,0
662568995,Rob Wykes,428102632,Anthony Flynn,2,2,0
662568995,Rob Wykes,670256222,Connor Anderson,2,2,0
662568995,Rob Wykes,752709358,Chris Mason,2,1,1
662568995,Rob Wykes,797962517,Dave Lewis,2,2,0
662568995,Rob Wykes,963958265,Rodney Moogan,2,1,1
666735933,Mike Collier,317,Austin Blackman,2,2,0
666735933,Mike Collier,326,Stefan Chandler,2,2,0
666735933,Mike Collier,90176364,David Page,2,2,0
666735933,Mike Collier,112887737,Pip Akehurst,2,2,0
666735933,Mike Collier,426009127,Bav Patel,2,2,0
666735933,Mike Collier,600385553,Darren Welfare,2,2,0
666735933,Mike Collier,764177688,Barry Martin,2,2,0
666735933,Mike Collier,948504778,Jon Fordham,2,1,1
666735933,Mike Collier,963958265,Rodney Moogan,2,2,0
667627563,Aeran Jenkinson,574248035,Tony Mulhern,2,2,0
669385277,Steve Towler,182,Brian Welfare,2,2,0
669385277,Steve Towler,202,Bob Firth,2,2,0
669385277,Steve Towler,231445676,Tony Paice,2,2,0
669385277,Steve Towler,573567936,Steve Marriott,2,2,0
669385277,Steve Towler,703030938,Ollie Thurmer,2,2,0
669385277,Steve Towler,880982797,Ray Hunter,2,1,1
669385277,Steve Towler,929636592,Danny Wilson,2,2,0
670034050,John Muzio,97,Shaun Winsor,2,2,0
670034050,John Muzio,223983583,Carl Wentworth,2,2,0
670034050,John Muzio,225850882,John McLellan,2,2,0
670034050,John Muzio,409212679,Mark Chapman,2,2,0
670034050,John Muzio,455401154,Kai Ellis,2,2,0
670034050,John Muzio,713064363,John Trory,2,2,0
670034050,John Muzio,732415457,Barry Hall,2,2,0
670034050,John Muzio,836895047,Ian McKay,2,2,0
670034050,John Muzio,915035871,Kevin Graysmark,2,2,0
670034050,John Muzio,948504778,Jon Fordham,2,1,1
670034050,John Muzio,954297832,Pav Sareen,2,1,1
670256222,Connor Anderson,63,Colin Penson,2,2,0
670256222,Connor Anderson,70,Michael Turner-Lee,2,2,0
670256222,Connor Anderson,88,Steve Collins,2,2,0
670256222,Connor Anderson,295,Graham Still,2,2,0
670256222,Connor Anderson,171346729,Des Heasman,2,2,0
670256222,Connor Anderson,490170224,Jamie Matthews,2,2,0
670256222,Connor Anderson,506581042,Glen Dartnell,2,2,0
670256222,Connor Anderson,717256135,Trevor Pickard,2,2,0
670256222,Connor Anderson,802242736,Steve Hughes,2,2,0
670256222,Connor Anderson,837429850,Paul Beecham,2,2,0
670256222,Connor Anderson,878576746,Jon Hall,2,2,0
670256222,Connor Anderson,947143243,Chris Davis,2,2,0
670870044,David Flanagan,27255501,Tom Lane,2,2,0
670870044,David Flanagan,501266206,David Fox,2,2,0
670870044,David Flanagan,567624732,Dave Brampton,2,2,0
670870044,David Flanagan,724342701,Nigel Lilley,2,2,0
670870044,David Flanagan,737709582,Tony Browne,2,1,1
670870044,David Flanagan,867613624,Ian Dunhill,2,2,0
670870044,David Flanagan,899206834,Jez Downs,2,1,1
670870044,David Flanagan,929636592,Danny Wilson,2,2,0
676753614,Don James,873916947,Geoff Akehurst,2,2,0
676753614,Don James,884374645,Wayne Iddon,2,1,1
676753614,Don James,929636592,Danny Wilson,2,2,0
677110925,Jake Dunstall,386517733,Ady Halley,2,2,0
677110925,Jake Dunstall,495939788,Tyrone Davis,2,2,0
677110925,Jake Dunstall,713064363,John Trory,2,2,0
680442672,Scott Lawson,34787509,Dave McCarthy,2,2,0
680442672,Scott Lawson,112887737,Pip Akehurst,2,2,0
680442672,Scott Lawson,800114325,Roger Whiteley,2,1,1
680442672,Scott Lawson,822983250,Alasdair Pratt,2,1,1
680442672,Scott Lawson,825399596,Pat Adams,2,1,1
680442672,Scott Lawson,878576746,Jon Hall,2,1,1
680442672,Scott Lawson,949603489,Pete Bennett,2,2,0
688252012,Sean Cooper,80,Dave Wells,2,2,0
688252012,Sean Cooper,27255501,Tom Lane,2,2,0
688252012,Sean Cooper,35191252,Nigel Hayward,2,2,0
688252012,Sean Cooper,83590771,Nick Brayne,2,2,0
688252012,Sean Cooper,271464632,Paul Phillips,2,2,0
688252012,Sean Cooper,349269645,Barry Thornton,2,2,0
688252012,Sean Cooper,417786644,Eddie Collins,2,2,0
688252012,Sean Cooper,584652998,Harry Stone,2,2,0
688252012,Sean Cooper,612265840,Paul Honeysett,2,2,0
688252012,Sean Cooper,649240057,Mike Childs,2,2,0
688252012,Sean Cooper,728690686,Rick Rothschild,2,1,1
688252012,Sean Cooper,820231590,Alan Rook,2,1,1
688252012,Sean Cooper,910809545,Blake Harman,2,1,1
688749133,Dan Hease,657320021,Brett Strevens,2,2,0
688749133,Dan Hease,740135236,Craig Marchant,2,1,1
688778183,Dean Paice,16,Mick Beck,2,2,0
688778183,Dean Paice,61,Paul Gander,2,2,0
688778183,Dean Paice,63,Colin Penson,2,2,0
688778183,Dean Paice,70,Michael Turner-Lee,2,2,0
688778183,Dean Paice,27255501,Tom Lane,2,2,0
688778183,Dean Paice,41461520,Luke Pooley,2,2,0
688778183,Dean Paice,110039677,Mick Miller,2,2,0
688778183,Dean Paice,207592931,(shorty) Gediminas Aleksandravicius,2,2,0
688778183,Dean Paice,291198629,Tony Burt,2,2,0
688778183,Dean Paice,291816585,Jim Somers,2,2,0
688778183,Dean Paice,349269645,Barry Thornton,2,2,0
688778183,Dean Paice,426236650,Dave Parrott,2,2,0
688778183,Dean Paice,573567936,Steve Marriott,2,2,0
688778183,Dean Paice,612265840,Paul Honeysett,2,2,0
688778183,Dean Paice,661923191,Steve Gardner,2,2,0
688778183,Dean Paice,669385277,Steve Towler,2,2,0
688778183,Dean Paice,688252012,Sean Cooper,2,2,0
688778183,Dean Paice,717256135,Trevor Pickard,2,2,0
688778183,Dean Paice,867613624,Ian Dunhill,2,1,1
688778183,Dean Paice,910809545,Blake Harman,2,1,1
688778183,Dean Paice,947620111,Neil Cutler,2,2,0
688778183,Dean Paice,953512654,Les Berry,2,2,0
703030938,Ollie Thurmer,745152759,Kevin Jewell,2,2,0
704007508,Alan Muir,3508579,John Murray,2,2,0
704007508,Alan Muir,28382047,Steve Harrington,2,2,0
704007508,Alan Muir,35191252,Nigel Hayward,2,2,0
704007508,Alan Muir,225247539,Barry Knight,2,2,0
704007508,Alan Muir,246154671,Alan Gunn,2,2,0
704007508,Alan Muir,266477517,Tony Baxter,2,2,0
704007508,Alan Muir,410854609,Dave Lowe,2,2,0
704007508,Alan Muir,430890681,Malcolm Cooper,2,2,0
704007508,Alan Muir,495939788,Tyrone Davis,2,2,0
704007508,Alan Muir,612265840,Paul Honeysett,2,2,0
704007508,Alan Muir,835713833,Olly Stewart,2,1,1
704007508,Alan Muir,836895047,Ian McKay,2,1,1
704007508,Alan Muir,880982797,Ray Hunter,2,2,0
704007508,Alan Muir,962678119,John Worth,2,2,0
713064363,John Trory,69745818,Ian Bowles,2,2,0
713064363,John Trory,291816585,Jim Somers,2,2,0
713064363,John Trory,444350794,Richard Freeman,2,2,0
717256135,Trevor Pickard,133,Darren Bradley,2,2,0
717256135,Trevor Pickard,26970170,Kai Michael,2,2,0
717256135,Trevor Pickard,213264678,Martin Hall,2,2,0
717256135,Trevor Pickard,797313851,Dave Anderson,2,2,0
717256135,Trevor Pickard,866506631,Mark Smith,2,1,1
717256135,Trevor Pickard,948504778,Jon Fordham,2,1,1
719124015,Tony Power,306438070,Martin Stocker,2,2,0
719124015,Tony Power,436708540,Bob Henley,2,2,0
719124015,Tony Power,661923191,Steve Gardner,2,2,0
719124015,Tony Power,704007508,Alan Muir,2,2,0
719124015,Tony Power,732415457,Barry Hall,2,1,1
719124015,Tony Power,889684922,Zixun Wang,2,1,1
719124015,Tony Power,948504778,Jon Fordham,2,1,1
721321839,Matt Peake,321,Mick Ingram,2,2,0
721321839,Matt Peake,655917217,Terry Mills,2,2,0
721321839,Matt Peake,680442672,Scott Lawson,2,2,0
721321839,Matt Peake,717256135,Trevor Pickard,2,2,0
721321839,Matt Peake,736672590,Dean Perry,2,2,0
721321839,Matt Peake,773216781,Sean Payne,2,1,1
721321839,Matt Peake,848997254,Tom Parker,2,1,1
721321839,Matt Peake,970786910,Kevin Sorrell,2,1,1
721321839,Matt Peake,971308746,Clive Harman,2,2,0
724342701,Nigel Lilley,171346729,Des Heasman,2,2,0
724342701,Nigel Lilley,319057545,Brendan Lambe,2,2,0
724342701,Nigel Lilley,737709582,Tony Browne,2,2,0
724342701,Nigel Lilley,867613624,Ian Dunhill,2,2,0
724342701,Nigel Lilley,936624299,Peter Gallant,2,2,0
728690686,Rick Rothschild,173,Dave Alderton,2,2,0
728690686,Rick Rothschild,440,Gordon Carter,2,2,0
728690686,Rick Rothschild,114184042,Ian Smith,2,2,0
728690686,Rick Rothschild,287057630,Darren Hearn,2,2,0
728690686,Rick Rothschild,484159049,Tommy Wright,2,2,0
732321233,Nathan Brooks,70,Michael Turner-Lee,2,2,0
732321233,Nathan Brooks,321,Mick Ingram,2,2,0
732321233,Nathan Brooks,436708540,Bob Henley,2,2,0
732321233,Nathan Brooks,836895047,Ian McKay,2,1,1
732415457,Barry Hall,92,Dale Thomas,2,2,0
732415457,Barry Hall,327948141,Ross Etheridge,2,2,0
732415457,Barry Hall,360777082,Mark Bishop,2,2,0
732415457,Barry Hall,386517733,Ady Halley,2,2,0
732415457,Barry Hall,394906196,Mick Mabbitt,2,2,0
732415457,Barry Hall,501266206,David Fox,2,2,0
732415457,Barry Hall,515177310,James Da Costa,2,2,0
732415457,Barry Hall,728690686,Rick Rothschild,2,2,0
732415457,Barry Hall,858283721,Dave Dunstall,2,1,1
732415457,Barry Hall,873916947,Geoff Akehurst,2,2,0
732415457,Barry Hall,915035871,Kevin Graysmark,2,2,0
732415457,Barry Hall,968651401,Ryan Grover,2,2,0
732415457,Barry Hall,970786910,Kevin Sorrell,2,1,1
733453947,Phil Canham,173,Dave Alderton,2,2,0
733453947,Phil Canham,179,Mick Jones,2,2,0
733453947,Phil Canham,319,John Lojo,2,2,0
733453947,Phil Canham,3508579,John Murray,2,2,0
733453947,Phil Canham,27255501,Tom Lane,2,2,0
733453947,Phil Canham,160950731,Locky McCurdy,2,2,0
733453947,Phil Canham,291816585,Jim Somers,2,2,0
733453947,Phil Canham,351143642,Michael Palmer,2,2,0
733453947,Phil Canham,417786644,Eddie Collins,2,2,0
733453947,Phil Canham,449331249,Dan Tanner,2,2,0
733453947,Phil Canham,529382351,Greg Foat,2,2,0
733453947,Phil Canham,535728699,Fred Cooper,2,2,0
733453947,Phil Canham,820231590,Alan Rook,2,2,0
733453947,Phil Canham,901024459,Paul Charman,2,2,0
733453947,Phil Canham,936624299,Peter Gallant,2,2,0
733453947,Phil Canham,954639632,Derek Budde,2,1,1
733453947,Phil Canham,962678119,John Worth,2,2,0
734416600,DON PENALVER,463709832,Danny Wong,2,2,0
736672590,Dean Perry,456,Daniel Marcantonio,2,2,0
736672590,Dean Perry,39289507,Mick Laughlin,2,2,0
736672590,Dean Perry,567316488,Lee Millyard,2,2,0
736672590,Dean Perry,728690686,Rick Rothschild,2,2,0
736672590,Dean Perry,873916947,Geoff Akehurst,2,2,0
736672590,Dean Perry,922772801,Nick Buonanno,2,1,1
737709582,Tony Browne,56252722,Dave Pither,2,2,0
737709582,Tony Browne,417786644,Eddie Collins,2,2,0
737709582,Tony Browne,484159049,Tommy Wright,2,2,0
737709582,Tony Browne,617252199,Jim Griffiths,2,2,0
737709582,Tony Browne,804381932,Ryan Harman,2,1,1
737709582,Tony Browne,889234854,Paul Smith,2,2,0
745152759,Kevin Jewell,873916947,Geoff Akehurst,2,2,0
746406369,Loz O'Keefe,80,Dave Wells,2,2,0
746406369,Loz O'Keefe,97,Shaun Winsor,2,2,0
746406369,Loz O'Keefe,316,Paul Redgate,2,2,0
746406369,Loz O'Keefe,371,Laurence Park,2,2,0
746406369,Loz O'Keefe,411,Phil Osbourne,2,2,0
746406369,Loz O'Keefe,440,Gordon Carter,2,2,0
746406369,Loz O'Keefe,160950731,Locky McCurdy,2,2,0
746406369,Loz O'Keefe,246154671,Alan Gunn,2,2,0
746406369,Loz O'Keefe,386517733,Ady Halley,2,2,0
746406369,Loz O'Keefe,417786644,Eddie Collins,2,2,0
746406369,Loz O'Keefe,809984729,Neil Scutt,2,1,1
746406369,Loz O'Keefe,929636592,Danny Wilson,2,1,1
746406369,Loz O'Keefe,968651401,Ryan Grover,2,2,0
746406369,Loz O'Keefe,978156264,Bob Paine,2,2,0
747966869,Richard Morgan,809984729,Neil Scutt,2,1,1
747966869,Richard Morgan,929636592,Danny Wilson,2,1,1
748064029,Paul Hughes,9,Michael Cheung,2,2,0
748064029,Paul Hughes,136,Dave Bonwick,2,2,0
748064029,Paul Hughes,112887737,Pip Akehurst,2,2,0
748064029,Paul Hughes,144293731,Simon Parry,2,2,0
748064029,Paul Hughes,293122482,Stuart Maplesden,2,2,0
748064029,Paul Hughes,463709832,Danny Wong,2,2,0
748064029,Paul Hughes,523395206,Jamie Lashmar,2,2,0
748064029,Paul Hughes,654650203,Alan O'Sullivan,2,2,0
748064029,Paul Hughes,797962517,Dave Lewis,2,2,0
748064029,Paul Hughes,825399596,Pat Adams,2,2,0
748064029,Paul Hughes,837429850,Paul Beecham,2,2,0
752709358,Chris Mason,365,Dan Buckwell,2,2,0
752709358,Chris Mason,432,Vincent Elphick,2,2,0
752709358,Chris Mason,26970170,Kai Michael,2,2,0
752709358,Chris Mason,289915561,Craig Dummer,2,2,0
752709358,Chris Mason,506320151,Frank Taylor,2,2,0
752709358,Chris Mason,680442672,Scott Lawson,2,2,0
752709358,Chris Mason,802242736,Steve Hughes,2,2,0
752709358,Chris Mason,809568302,Mark Johnson,2,1,1
752709358,Chris Mason,876526526,Ash Bull,2,2,0
752709358,Chris Mason,947143243,Chris Davis,2,2,0
752709358,Chris Mason,954080507,Sam Corsby,2,1,1
752709358,Chris Mason,963958265,Rodney Moogan,2,2,0
754250007,Freddie Blunden,8,Colin Barber,2,2,0
754250007,Freddie Blunden,392,Gareth Milburn,2,2,0
754250007,Freddie Blunden,90176364,David Page,2,2,0
754250007,Freddie Blunden,231975313,Danny English,2,2,0
754250007,Freddie Blunden,258340682,John Derret,2,2,0
754250007,Freddie Blunden,680442672,Scott Lawson,2,2,0
754250007,Freddie Blunden,764177688,Barry Martin,2,2,0
754250007,Freddie Blunden,809647573,John Taylor,2,2,0
754250007,Freddie Blunden,850059806,Heng Wong,2,2,0
754250007,Freddie Blunden,927588200,Tokki Yamaguchi,2,1,1
754250007,Freddie Blunden,931210057,Huntley Roberts,2,2,0
754250007,Freddie Blunden,948504778,Jon Fordham,2,2,0
757827662,Clive Freestone,402257815,Jim Cumming,2,2,0
757827662,Clive Freestone,800114325,Roger Whiteley,2,1,1
757827662,Clive Freestone,880982797,Ray Hunter,2,1,1
764177688,Barry Martin,171,Darren Bell,2,2,0
764177688,Barry Martin,963958265,Rodney Moogan,2,2,0
766684900,John Gillard,8,Colin Barber,2,2,0
766684900,John Gillard,88,Steve Collins,2,2,0
766684900,John Gillard,137,Ricky Beecham,2,2,0
766684900,John Gillard,5820499,Paul Bartlett,2,2,0
766684900,John Gillard,26970170,Kai Michael,2,2,0
766684900,John Gillard,662568995,Rob Wykes,2,2,0
766684900,John Gillard,748064029,Paul Hughes,2,2,0
766684900,John Gillard,764177688,Barry Martin,2,2,0
766684900,John Gillard,794630189,Mark Coles,2,1,1
766684900,John Gillard,797962517,Dave Lewis,2,2,0
766684900,John Gillard,809568302,Mark Johnson,2,2,0
766684900,John Gillard,927588200,Tokki Yamaguchi,2,2,0
773216781,Sean Payne,39289507,Mick Laughlin,2,2,0
773216781,Sean Payne,415524562,Dave King,2,2,0
773216781,Sean Payne,426009127,Bav Patel,2,2,0
773216781,Sean Payne,670034050,John Muzio,2,2,0
773216781,Sean Payne,734416600,DON PENALVER,2,2,0
773216781,Sean Payne,802242736,Steve Hughes,2,1,1
773216781,Sean Payne,848997254,Tom Parker,2,1,1
773216781,Sean Payne,867613624,Ian Dunhill,2,2,0
773216781,Sean Payne,889234854,Paul Smith,2,2,0
773216781,Sean Payne,954080507,Sam Corsby,2,2,0
773216781,Sean Payne,954297832,Pav Sareen,2,1,1
788605510,Mark Rose,114184042,Ian Smith,2,2,0
788605510,Mark Rose,349269645,Barry Thornton,2,2,0
788605510,Mark Rose,360777082,Mark Bishop,2,2,0
788605510,Mark Rose,493830161,Luke Strevens,2,2,0
788605510,Mark Rose,567316488,Lee Millyard,2,2,0
788605510,Mark Rose,613893140,Matt Warner,2,2,0
788605510,Mark Rose,733453947,Phil Canham,2,2,0
788605510,Mark Rose,800114325,Roger Whiteley,2,2,0
794630189,Mark Coles,26970170,Kai Michael,2,2,0
794630189,Mark Coles,515186402,Ben Evans,2,2,0
797313851,Dave Anderson,225850882,John McLellan,2,2,0
797313851,Dave Anderson,878576746,Jon Hall,2,1,1
797313851,Dave Anderson,949603489,Pete Bennett,2,1,1
797962517,Dave Lewis,34787509,Dave McCarthy,2,2,0
797962517,Dave Lewis,192463126,Gerry Lindsey,2,2,0
797962517,Dave Lewis,683709119,Ronnie Beard,2,2,0
797962517,Dave Lewis,809788967,Brett Williams,2,1,1
797962517,Dave Lewis,825399596,Pat Adams,2,1,1
797962517,Dave Lewis,837429850,Paul Beecham,2,1,1
800114325,Roger Whiteley,56252722,Dave Pither,2,2,0
800114325,Roger Whiteley,112887737,Pip Akehurst,2,2,0
800114325,Roger Whiteley,327948141,Ross Etheridge,2,2,0
800114325,Roger Whiteley,430602171,Steve Morgan,2,2,0
800114325,Roger Whiteley,688252012,Sean Cooper,2,2,0
800114325,Roger Whiteley,704007508,Alan Muir,2,2,0
800114325,Roger Whiteley,873916947,Geoff Akehurst,2,2,0
802242736,Steve Hughes,136,Dave Bonwick,2,2,0
802242736,Steve Hughes,271464632,Paul Phillips,2,2,0
802242736,Steve Hughes,364867274,Dave Lucking,2,2,0
802242736,Steve Hughes,797962517,Dave Lewis,2,2,0
805165161,Steve Owen,40,Shykul Malique,2,2,0
805165161,Steve Owen,117247901,Dave Verey,2,2,0
805165161,Steve Owen,444350794,Richard Freeman,2,2,0
805165161,Steve Owen,670034050,John Muzio,2,2,0
805165161,Steve Owen,713064363,John Trory,2,2,0
805165161,Steve Owen,809647573,John Taylor,2,2,0
805165161,Steve Owen,848997254,Tom Parker,2,1,1
805165161,Steve Owen,954080507,Sam Corsby,2,1,1
809568302,Mark Johnson,8,Colin Barber,2,2,0
809568302,Mark Johnson,222,John Newnhan,2,2,0
809568302,Mark Johnson,683709119,Ronnie Beard,2,2,0
809568302,Mark Johnson,850059806,Heng Wong,2,2,0
809568302,Mark Johnson,947143243,Chris Davis,2,1,1
809647573,John Taylor,70,Michael Turner-Lee,2,2,0
809647573,John Taylor,321,Mick Ingram,2,2,0
809647573,John Taylor,114319292,Oliver Gorrod,2,2,0
809647573,John Taylor,747966869,Richard Morgan,2,2,0
809647573,John Taylor,809984729,Neil Scutt,2,1,1
809788967,Brett Williams,213264678,Martin Hall,2,2,0
809788967,Brett Williams,436708540,Bob Henley,2,2,0
809984729,Neil Scutt,246154671,Alan Gunn,2,2,0
809984729,Neil Scutt,287057630,Darren Hearn,2,2,0
809984729,Neil Scutt,736672590,Dean Perry,2,2,0
809984729,Neil Scutt,833156731,Jez Saunders,2,2,0
809984729,Neil Scutt,845758589,Charlie James,2,2,0
809984729,Neil Scutt,884374645,Wayne Iddon,2,2,0
810143915,Ben Welfare,75,Chris Rea,2,2,0
810143915,Ben Welfare,172646809,Robin Powell,2,2,0
810143915,Ben Welfare,567316488,Lee Millyard,2,2,0
810143915,Ben Welfare,719124015,Tony Power,2,2,0
810143915,Ben Welfare,974385564,Danny Booker,2,1,1
815023707,David Senior,445,Lachlan Monroe,2,2,0
815023707,David Senior,495,Louie Nayna,2,2,0
815023707,David Senior,495939788,Tyrone Davis,2,2,0
820231590,Alan Rook,102,Reece Childs,2,2,0
820231590,Alan Rook,515,Simon Mackenzie,2,2,0
820231590,Alan Rook,160950731,Locky McCurdy,2,2,0
820231590,Alan Rook,363402934,Rod Phillippe,2,2,0
820231590,Alan Rook,704007508,Alan Muir,2,2,0
820231590,Alan Rook,856755662,David Marsh,2,1,1
820231590,Alan Rook,953512654,Les Berry,2,2,0
820231590,Alan Rook,966905561,Tony Dade,2,1,1
822983250,Alasdair Pratt,356,Scott Harris,2,2,0
822983250,Alasdair Pratt,160950731,Locky McCurdy,2,2,0
822983250,Alasdair Pratt,291816585,Jim Somers,2,2,0
822983250,Alasdair Pratt,436708540,Bob Henley,2,2,0
822983250,Alasdair Pratt,836895047,Ian McKay,2,1,1
822983250,Alasdair Pratt,878576746,Jon Hall,2,2,0
822983250,Alasdair Pratt,949603489,Pete Bennett,2,2,0
825399596,Pat Adams,114184042,Ian Smith,2,2,0
825399596,Pat Adams,133207947,Jake Richardson,2,2,0
825399596,Pat Adams,356397577,David Morgan,2,2,0
825399596,Pat Adams,766684900,John Gillard,2,2,0
831214643,Tony Shipley,41461520,Luke Pooley,2,2,0
831214643,Tony Shipley,160950731,Locky McCurdy,2,2,0
831214643,Tony Shipley,417786644,Eddie Collins,2,2,0
831214643,Tony Shipley,463709832,Danny Wong,2,2,0
831214643,Tony Shipley,464085958,Gerwyn Bowen,2,2,0
831214643,Tony Shipley,495939788,Tyrone Davis,2,2,0
831214643,Tony Shipley,498330760,Mo Collins,2,2,0
831214643,Tony Shipley,613893140,Matt Warner,2,2,0
831214643,Tony Shipley,820231590,Alan Rook,2,2,0
831214643,Tony Shipley,833156731,Jez Saunders,2,2,0
831214643,Tony Shipley,866506631,Mark Smith,2,1,1
831214643,Tony Shipley,978156264,Bob Paine,2,2,0
833156731,Jez Saunders,291816585,Jim Somers,2,2,0
833156731,Jez Saunders,713064363,John Trory,2,2,0
835713833,Olly Stewart,27255501,Tom Lane,2,2,0
835713833,Olly Stewart,114319292,Oliver Gorrod,2,2,0
835713833,Olly Stewart,160950731,Locky McCurdy,2,2,0
835713833,Olly Stewart,287057630,Darren Hearn,2,2,0
835713833,Olly Stewart,349269645,Barry Thornton,2,2,0
835713833,Olly Stewart,392533233,Jack Wright,2,2,0
835713833,Olly Stewart,560540608,Mark Siddle,2,2,0
835713833,Olly Stewart,574248035,Tony Mulhern,2,2,0
835713833,Olly Stewart,612265840,Paul Honeysett,2,2,0
835713833,Olly Stewart,833156731,Jez Saunders,2,2,0
835713833,Olly Stewart,889234854,Paul Smith,2,2,0
835713833,Olly Stewart,943667183,John Stone,2,2,0
835713833,Olly Stewart,963206772,Dean Moore,2,1,1
836895047,Ian McKay,78,Kevin Baker,2,2,0
836895047,Ian McKay,133207947,Jake Richardson,2,2,0
836895047,Ian McKay,529382351,Greg Foat,2,2,0
836895047,Ian McKay,598846718,Ben Sorrell,2,2,0
836895047,Ian McKay,613893140,Matt Warner,2,2,0
836895047,Ian McKay,649307517,Wes Kingham,2,2,0
836895047,Ian McKay,721321839,Matt Peake,2,2,0
836895047,Ian McKay,848997254,Tom Parker,2,1,1
836895047,Ian McKay,880982797,Ray Hunter,2,2,0
837429850,Paul Beecham,5820499,Paul Bartlett,2,2,0
837429850,Paul Beecham,183400466,David Wright,2,2,0
837429850,Paul Beecham,899206834,Jez Downs,2,2,0
843981340,Mark Glover,172646809,Robin Powell,2,2,0
843981340,Mark Glover,258549102,Tony Lee,2,2,0
843981340,Mark Glover,279543944,Peter Maurice,2,2,0
843981340,Mark Glover,294944526,Rob Teanby,2,2,0
843981340,Mark Glover,845758589,Charlie James,2,2,0
844676925,Kieran Williams,101,Jason Childs,2,2,0
844676925,Kieran Williams,239,Mick Lucas,2,2,0
844676925,Kieran Williams,282,Adam Harrild,2,2,0
844676925,Kieran Williams,225247539,Barry Knight,2,2,0
844676925,Kieran Williams,820231590,Alan Rook,2,2,0
844676925,Kieran Williams,943667183,John Stone,2,2,0
844676925,Kieran Williams,963206772,Dean Moore,2,1,1
845537273,Dave Gridley,76,David Rea,2,2,0
845537273,Dave Gridley,153,Tony Leach,2,2,0
845537273,Dave Gridley,337,Adam Williams,2,2,0
845537273,Dave Gridley,3508579,John Murray,2,2,0
845537273,Dave Gridley,213264678,Martin Hall,2,2,0
845537273,Dave Gridley,225850882,John McLellan,2,2,0
845537273,Dave Gridley,641692362,Bob Taylor,2,2,0
845537273,Dave Gridley,974385564,Danny Booker,2,1,1
845758589,Charlie James,495939788,Tyrone Davis,2,2,0
845758589,Charlie James,858283721,Dave Dunstall,2,2,0
845758589,Charlie James,915035871,Kevin Graysmark,2,1,1
845758589,Charlie James,929636592,Danny Wilson,2,1,1
845758589,Charlie James,978156264,Bob Paine,2,2,0
848997254,Tom Parker,231975313,Danny English,2,2,0
848997254,Tom Parker,484159049,Tommy Wright,2,2,0
848997254,Tom Parker,655917217,Terry Mills,2,2,0
848997254,Tom Parker,713064363,John Trory,2,2,0
848997254,Tom Parker,899206834,Jez Downs,2,1,1
850059806,Heng Wong,719124015,Tony Power,2,2,0
850059806,Heng Wong,837429850,Paul Beecham,2,2,0
850059806,Heng Wong,865803068,Dave Jones,2,1,1
852327692,Andy Fletcher,417786644,Eddie Collins,2,2,0
856755662,David Marsh,529382351,Greg Foat,2,2,0
856755662,David Marsh,724342701,Nigel Lilley,2,2,0
858283721,Dave Dunstall,78,Kevin Baker,2,2,0
858283721,Dave Dunstall,309,M. Humphries,2,2,0
858283721,Dave Dunstall,225247539,Barry Knight,2,2,0
858283721,Dave Dunstall,231975313,Danny English,2,2,0
858283721,Dave Dunstall,537640521,Ian Stoner,2,2,0
858283721,Dave Dunstall,966905561,Tony Dade,2,2,0
858283721,Dave Dunstall,978156264,Bob Paine,2,2,0
865803068,Dave Jones,754250007,Freddie Blunden,2,2,0
865803068,Dave Jones,802242736,Steve Hughes,2,2,0
865803068,Dave Jones,963958265,Rodney Moogan,2,2,0
866506631,Mark Smith,306438070,Martin Stocker,2,2,0
866506631,Mark Smith,319057545,Brendan Lambe,2,2,0
866506631,Mark Smith,360777082,Mark Bishop,2,2,0
866506631,Mark Smith,444350794,Richard Freeman,2,2,0
866506631,Mark Smith,670034050,John Muzio,2,2,0
866506631,Mark Smith,878576746,Jon Hall,2,1,1
866506631,Mark Smith,880982797,Ray Hunter,2,1,1
866506631,Mark Smith,971308746,Clive Harman,2,2,0
867613624,Ian Dunhill,456,Daniel Marcantonio,2,2,0
867613624,Ian Dunhill,223983583,Carl Wentworth,2,2,0
867613624,Ian Dunhill,319057545,Brendan Lambe,2,2,0
867613624,Ian Dunhill,349269645,Barry Thornton,2,2,0
867613624,Ian Dunhill,386517733,Ady Halley,2,2,0
867613624,Ian Dunhill,495939788,Tyrone Davis,2,2,0
867613624,Ian Dunhill,498330760,Mo Collins,2,2,0
867613624,Ian Dunhill,524571340,Mohammed Alhdi,2,2,0
867613624,Ian Dunhill,535728699,Fred Cooper,2,2,0
867613624,Ian Dunhill,598846718,Ben Sorrell,2,2,0
867613624,Ian Dunhill,612265840,Paul Honeysett,2,2,0
867613624,Ian Dunhill,815023707,David Senior,2,2,0
867613624,Ian Dunhill,845758589,Charlie James,2,2,0
867613624,Ian Dunhill,966905561,Tony Dade,2,1,1
876526526,Ash Bull,428102632,Anthony Flynn,2,2,0
876526526,Ash Bull,523395206,Jamie Lashmar,2,2,0
876526526,Ash Bull,884365412,Dave Haslam,2,2,0
876526526,Ash Bull,957784480,Harry Banks,2,2,0
878576746,Jon Hall,26970170,Kai Michael,2,2,0
878576746,Jon Hall,118679261,Mick Lott,2,2,0
878576746,Jon Hall,719124015,Tony Power,2,2,0
878576746,Jon Hall,889234854,Paul Smith,2,1,1
880982797,Ray Hunter,279543944,Peter Maurice,2,2,0
880982797,Ray Hunter,495939788,Tyrone Davis,2,2,0
884365412,Dave Haslam,121,Mike Barnett,2,2,0
884365412,Dave Haslam,114184042,Ian Smith,2,2,0
884365412,Dave Haslam,171346729,Des Heasman,2,2,0
884365412,Dave Haslam,279543944,Peter Maurice,2,2,0
884365412,Dave Haslam,412256116,Andy Sutton,2,2,0
884374645,Wayne Iddon,820231590,Alan Rook,2,2,0
884374645,Wayne Iddon,822983250,Alasdair Pratt,2,2,0
884374645,Wayne Iddon,948504778,Jon Fordham,2,1,1
884374645,Wayne Iddon,951468676,Steve Burchett,2,1,1
889234854,Paul Smith,28,Simon Parker,2,2,0
889234854,Paul Smith,121,Mike Barnett,2,2,0
889234854,Paul Smith,402257815,Jim Cumming,2,2,0
889234854,Paul Smith,411473516,Ray Canham,2,2,0
889234854,Paul Smith,436708540,Bob Henley,2,2,0
889234854,Paul Smith,915035871,Kevin Graysmark,2,1,1
889234854,Paul Smith,971308746,Clive Harman,2,1,1
889684922,Zixun Wang,669385277,Steve Towler,2,2,0
889684922,Zixun Wang,670034050,John Muzio,2,2,0
899206834,Jez Downs,27255501,Tom Lane,2,2,0
899206834,Jez Downs,171346729,Des Heasman,2,2,0
899206834,Jez Downs,223983583,Carl Wentworth,2,2,0
899206834,Jez Downs,386517733,Ady Halley,2,2,0
899206834,Jez Downs,402257815,Jim Cumming,2,2,0
899206834,Jez Downs,745152759,Kevin Jewell,2,2,0
899206834,Jez Downs,951468676,Steve Burchett,2,1,1
899206834,Jez Downs,980908578,Jake Whatman,2,1,1
901024459,Paul Charman,321,Mick Ingram,2,2,0
901024459,Paul Charman,160950731,Locky McCurdy,2,2,0
901024459,Paul Charman,172646809,Robin Powell,2,2,0
910809545,Blake Harman,287057630,Darren Hearn,2,2,0
910809545,Blake Harman,319057545,Brendan Lambe,2,2,0
910809545,Blake Harman,612265840,Paul Honeysett,2,2,0
915035871,Kevin Graysmark,38,Rob Bowden,2,2,0
915035871,Kevin Graysmark,81,Nick Bollingbroke,2,2,0
915035871,Kevin Graysmark,179,Mick Jones,2,2,0
915035871,Kevin Graysmark,510918620,Robert Bowden,2,2,0
915035871,Kevin Graysmark,677110925,Jake Dunstall,2,2,0
922772801,Nick Buonanno,456,Daniel Marcantonio,2,2,0
922772801,Nick Buonanno,402257815,Jim Cumming,2,2,0
922772801,Nick Buonanno,417786644,Eddie Collins,2,2,0
922772801,Nick Buonanno,598552542,John Colgan,2,2,0
922772801,Nick Buonanno,845758589,Charlie James,2,2,0
927588200,Tokki Yamaguchi,60575249,Ash Thurmer,2,2,0
927588200,Tokki Yamaguchi,646410961,Paul Scorer,2,2,0
927588200,Tokki Yamaguchi,748064029,Paul Hughes,2,2,0
927588200,Tokki Yamaguchi,957784480,Harry Banks,2,1,1
929636592,Danny Wilson,284,Ray Bradley,2,2,0
929636592,Danny Wilson,384,Bryan Beck,2,2,0
929636592,Danny Wilson,417786644,Eddie Collins,2,2,0
929636592,Danny Wilson,430890681,Malcolm Cooper,2,2,0
929636592,Danny Wilson,573567936,Steve Marriott,2,2,0
929636592,Danny Wilson,704007508,Alan Muir,2,2,0
929636592,Danny Wilson,740135236,Craig Marchant,2,2,0
931210057,Huntley Roberts,957784480,Harry Banks,2,1,1
936624299,Peter Gallant,495939788,Tyrone Davis,2,2,0
936624299,Peter Gallant,978156264,Bob Paine,2,2,0
943667183,John Stone,281,Bob Rumble,2,2,0
943667183,John Stone,515,Simon Mackenzie,2,2,0
943667183,John Stone,41461520,Luke Pooley,2,2,0
943667183,John Stone,69745818,Ian Bowles,2,2,0
943667183,John Stone,204951513,Mike Holding,2,2,0
943667183,John Stone,858283721,Dave Dunstall,2,2,0
943667183,John Stone,910809545,Blake Harman,2,2,0
947143243,Chris Davis,957784480,Harry Banks,2,2,0
948504778,Jon Fordham,59858690,James Constable,2,2,0
948504778,Jon Fordham,529382351,Greg Foat,2,2,0
948504778,Jon Fordham,613893140,Matt Warner,2,2,0
948504778,Jon Fordham,732321233,Nathan Brooks,2,2,0
948504778,Jon Fordham,745152759,Kevin Jewell,2,2,0
948504778,Jon Fordham,809788967,Brett Williams,2,2,0
948504778,Jon Fordham,957784480,Harry Banks,2,1,1
948504778,Jon Fordham,963206772,Dean Moore,2,2,0
949603489,Pete Bennett,259288142,Dale Edmonds,2,2,0
949603489,Pete Bennett,327948141,Ross Etheridge,2,2,0
949603489,Pete Bennett,409212679,Mark Chapman,2,2,0
949603489,Pete Bennett,412256116,Andy Sutton,2,2,0
949603489,Pete Bennett,463709832,Danny Wong,2,2,0
949603489,Pete Bennett,669385277,Steve Towler,2,2,0
949603489,Pete Bennett,728690686,Rick Rothschild,2,2,0
949603489,Pete Bennett,837429850,Paul Beecham,2,2,0
949603489,Pete Bennett,848997254,Tom Parker,2,2,0
949603489,Pete Bennett,866506631,Mark Smith,2,2,0
951468676,Steve Burchett,96,Dave Kellett,2,2,0
951468676,Steve Burchett,278,Dave Fairbairn,2,2,0
951468676,Steve Burchett,394906196,Mick Mabbitt,2,2,0
951468676,Steve Burchett,556095121,Tom Wright,2,2,0
951468676,Steve Burchett,669385277,Steve Towler,2,2,0
951468676,Steve Burchett,745152759,Kevin Jewell,2,2,0
951468676,Steve Burchett,809984729,Neil Scutt,2,2,0
951468676,Steve Burchett,845758589,Charlie James,2,2,0
951468676,Steve Burchett,936624299,Peter Gallant,2,2,0
951468676,Steve Burchett,968651401,Ryan Grover,2,1,1
953512654,Les Berry,171346729,Des Heasman,2,2,0
953512654,Les Berry,394906196,Mick Mabbitt,2,2,0
953512654,Les Berry,417786644,Eddie Collins,2,2,0
953512654,Les Berry,430890681,Malcolm Cooper,2,2,0
953512654,Les Berry,943667183,John Stone,2,2,0
954080507,Sam Corsby,121,Mike Barnett,2,2,0
954080507,Sam Corsby,300,Graham Smart,2,2,0
954080507,Sam Corsby,486,"Jim, Jr. Stevens",2,2,0
954080507,Sam Corsby,41098823,Mikey Booker,2,2,0
954080507,Sam Corsby,118679261,Mick Lott,2,2,0
954080507,Sam Corsby,411473516,Ray Canham,2,2,0
954080507,Sam Corsby,719124015,Tony Power,2,2,0
954080507,Sam Corsby,733453947,Phil Canham,2,2,0
954080507,Sam Corsby,836895047,Ian McKay,2,2,0
954080507,Sam Corsby,866506631,Mark Smith,2,2,0
954297832,Pav Sareen,717256135,Trevor Pickard,2,2,0
954297832,Pav Sareen,970786910,Kevin Sorrell,2,2,0
954639632,Derek Budde,319057545,Brendan Lambe,2,2,0
957784480,Harry Banks,136,Dave Bonwick,2,2,0
957784480,Harry Banks,306438070,Martin Stocker,2,2,0
957784480,Harry Banks,880982797,Ray Hunter,2,2,0
963206772,Dean Moore,83,Eric Gumbrell,2,2,0
963206772,Dean Moore,179,Mick Jones,2,2,0
963206772,Dean Moore,181,Dave Roughley,2,2,0
963206772,Dean Moore,27255501,Tom Lane,2,2,0
963206772,Dean Moore,146404254,Randall Griffiths,2,2,0
963206772,Dean Moore,319057545,Brendan Lambe,2,2,0
963206772,Dean Moore,351143642,Michael Palmer,2,2,0
963206772,Dean Moore,386517733,Ady Halley,2,2,0
963206772,Dean Moore,535728699,Fred Cooper,2,2,0
963206772,Dean Moore,688778183,Dean Paice,2,2,0
963206772,Dean Moore,703030938,Ollie Thurmer,2,2,0
963206772,Dean Moore,733453947,Phil Canham,2,2,0
963206772,Dean Moore,852327692,Andy Fletcher,2,2,0
963206772,Dean Moore,971308746,Clive Harman,2,2,0
963958265,Rodney Moogan,393,Mark Purser,2,2,0
963958265,Rodney Moogan,5820499,Paul Bartlett,2,2,0
963958265,Rodney Moogan,428102632,Anthony Flynn,2,2,0
963958265,Rodney Moogan,954297832,Pav Sareen,2,2,0
966905561,Tony Dade,494,Simon Bates,2,2,0
966905561,Tony Dade,415524562,Dave King,2,2,0
966905561,Tony Dade,426236650,Dave Parrott,2,2,0
966905561,Tony Dade,529382351,Greg Foat,2,2,0
966905561,Tony Dade,567624732,Dave Brampton,2,2,0
966905561,Tony Dade,649240057,Mike Childs,2,2,0
966905561,Tony Dade,676753614,Don James,2,2,0
968651401,Ryan Grover,386517733,Ady Halley,2,2,0
968651401,Ryan Grover,713064363,John Trory,2,2,0
970786910,Kevin Sorrell,78,Kevin Baker,2,2,0
970786910,Kevin Sorrell,28382047,Steve Harrington,2,2,0
970786910,Kevin Sorrell,114319292,Oliver Gorrod,2,2,0
970786910,Kevin Sorrell,225247539,Barry Knight,2,2,0
970786910,Kevin Sorrell,287057630,Darren Hearn,2,2,0
970786910,Kevin Sorrell,291816585,Jim Somers,2,2,0
970786910,Kevin Sorrell,351143642,Michael Palmer,2,2,0
970786910,Kevin Sorrell,394906196,Mick Mabbitt,2,2,0
970786910,Kevin Sorrell,402257815,Jim Cumming,2,2,0
970786910,Kevin Sorrell,498330760,Mo Collins,2,2,0
970786910,Kevin Sorrell,535728699,Fred Cooper,2,2,0
970786910,Kevin Sorrell,612265840,Paul Honeysett,2,2,0
970786910,Kevin Sorrell,867613624,Ian Dunhill,2,2,0
970786910,Kevin Sorrell,915035871,Kevin Graysmark,2,2,0
971308746,Clive Harman,144776055,Brian Wilkes,2,2,0
971308746,Clive Harman,227209116,Peter Rawlinson,2,2,0
971308746,Clive Harman,287057630,Darren Hearn,2,2,0
971308746,Clive Harman,444350794,Richard Freeman,2,2,0
971308746,Clive Harman,567316488,Lee Millyard,2,2,0
971308746,Clive Harman,612265840,Paul Honeysett,2,2,0
971308746,Clive Harman,713064363,John Trory,2,2,0
971308746,Clive Harman,724342701,Nigel Lilley,2,2,0
971308746,Clive Harman,820231590,Alan Rook,2,2,0
971308746,Clive Harman,867613624,Ian Dunhill,2,2,0
971308746,Clive Harman,899206834,Jez Downs,2,2,0
974385564,Danny Booker,114184042,Ian Smith,2,2,0
974385564,Danny Booker,171346729,Des Heasman,2,2,0
974385564,Danny Booker,231975313,Danny English,2,2,0
974385564,Danny Booker,327948141,Ross Etheridge,2,2,0
974385564,Danny Booker,402257815,Jim Cumming,2,2,0
974385564,Danny Booker,670034050,John Muzio,2,2,0
974385564,Danny Booker,726498878,Grigory Yashkov,2,2,0
974385564,Danny Booker,889234854,Paul Smith,2,2,0
974385564,Danny Booker,949603489,Pete Bennett,2,2,0
974385564,Danny Booker,963206772,Dean Moore,2,2,0
978156264,Bob Paine,318,Eddie Tuck,2,2,0
978156264,Bob Paine,32061370,Toby Prince-Iles,2,2,0
980908578,Jake Whatman,83,Eric Gumbrell,2,2,0
982531289,Rory Griffiths,386517733,Ady Halley,2,2,0
991443521,Adam Griffiths,41098823,Mikey Booker,2,2,0
