player_id,player_name,opponent_id,opponent_name,played,wins_left,wins_right
60575249,Ash Thurmer,748064029,Paul Hughes,23,5,18
96354463,Rob Pickard,802242736,Steve Hughes,20,5,15
278731588,Lester Grice,802242736,Steve Hughes,19,4,15
278731588,Lester Grice,341869673,Nigel Stilwell,17,16,1
428102632,Anthony Flynn,802242736,Steve Hughes,17,13,4
96354463,Rob Pickard,748064029,Paul Hughes,16,1,15
523395206,Jamie Lashmar,752709358,Chris Mason,15,7,8
341869673,Nigel Stilwell,957784480,Harry Banks,14,14,0
392533233,Jack Wright,845758589,Charlie James,13,6,7
646410961,Paul Scorer,748064029,Paul Hughes,13,10,3
180,Pat Sweeney,858283721,Dave Dunstall,12,3,9
59858690,James Constable,428102632,Anthony Flynn,12,8,4
59858690,James Constable,802242736,Steve Hughes,12,8,4
670256222,Connor Anderson,752709358,Chris Mason,12,4,8
11133032,Simon Dent,96103077,Paul Norris,11,7,4
11133032,Simon Dent,523395206,Jamie Lashmar,11,4,7
278731588,Lester Grice,428102632,Anthony Flynn,11,6,5
428102632,Anthony Flynn,809568302,Mark Johnson,11,2,9
646410961,Paul Scorer,957784480,Harry Banks,11,5,6
748064029,Paul Hughes,809568302,Mark Johnson,11,2,9
231445676,Tony Paice,529382351,Greg Foat,10,7,3
278731588,Lester Grice,670256222,Connor Anderson,10,1,9
278731588,Lester Grice,752709358,Chris Mason,10,1,9
426236650,Dave Parrott,649240057,Mike Childs,10,3,7
523395206,Jamie Lashmar,617751649,Lee Simpson,10,4,6
670256222,Connor Anderson,957784480,Harry Banks,10,8,2
748064029,Paul Hughes,948504778,Jon Fordham,10,3,7
754250007,Freddie Blunden,802242736,Steve Hughes,10,9,1
34787509,Dave McCarthy,802242736,Steve Hughes,9,7,2
59858690,James Constable,278731588,Lester Grice,9,7,2
96103077,Paul Norris,323907964,Russ Hughes,9,6,3
96103077,Paul Norris,752709358,Chris Mason,9,4,5
266591683,Chris Roche,529382351,Greg Foat,9,9,0
341869673,Nigel Stilwell,617751649,Lee Simpson,9,1,8
384960657,Dave Lewney,957784480,Harry Banks,9,7,2
428102632,Anthony Flynn,748064029,Paul Hughes,9,5,4
617751649,Lee Simpson,957784480,Harry Banks,9,7,2
646410961,Paul Scorer,752709358,Chris Mason,9,3,6
802242736,Steve Hughes,809568302,Mark Johnson,9,3,6
809568302,Mark Johnson,963958265,Rodney Moogan,9,7,2
820231590,Alan Rook,845758589,Charlie James,9,6,3
180,Pat Sweeney,16253983,Tony Simmonds,8,2,6
11133032,Simon Dent,323907964,Russ Hughes,8,4,4
11133032,Simon Dent,617751649,Lee Simpson,8,6,2
11133032,Simon Dent,752709358,Chris Mason,8,4,4
59858690,James Constable,646410961,Paul Scorer,8,1,7
60575249,Ash Thurmer,752709358,Chris Mason,8,1,7
96103077,Paul Norris,617751649,Lee Simpson,8,4,4
96103077,Paul Norris,794630189,Mark Coles,8,5,3
96354463,Rob Pickard,752709358,Chris Mason,8,0,8
114184042,Ian Smith,661923191,Steve Gardner,8,4,4
229719541,Scott Manning,394906196,Mick Mabbitt,8,7,1
278731588,Lester Grice,506581042,Glen Dartnell,8,5,3
323907964,Russ Hughes,345558874,Zack Richardson,8,2,6
394906196,Mick Mabbitt,936624299,Peter Gallant,8,1,7
426009127,Bav Patel,646410961,Paul Scorer,8,1,7
428102632,Anthony Flynn,617751649,Lee Simpson,8,3,5
506581042,Glen Dartnell,809568302,Mark Johnson,8,2,6
515186402,Ben Evans,752709358,Chris Mason,8,3,5
523395206,Jamie Lashmar,646410961,Paul Scorer,8,6,2
617751649,Lee Simpson,766684900,John Gillard,8,3,5
748064029,Paul Hughes,752709358,Chris Mason,8,1,7
754250007,Freddie Blunden,957784480,Harry Banks,8,6,2
948504778,Jon Fordham,963958265,Rodney Moogan,8,5,3
65,Paul Hudson,836895047,Ian McKay,7,6,1
124,Dave Tristram,954080507,Sam Corsby,7,1,6
180,Pat Sweeney,963206772,Dean Moore,7,6,1
16253983,Tony Simmonds,124523642,Tom Hayes,7,5,2
34787509,Dave McCarthy,428102632,Anthony Flynn,7,0,7
41098823,Mikey Booker,800114325,Roger Whiteley,7,2,5
96103077,Paul Norris,809568302,Mark Johnson,7,7,0
96354463,Rob Pickard,323907964,Russ Hughes,7,3,4
96354463,Rob Pickard,523395206,Jamie Lashmar,7,1,6
96354463,Rob Pickard,809568302,Mark Johnson,7,3,4
112887737,Pip Akehurst,428102632,Anthony Flynn,7,3,4
114184042,Ian Smith,574248035,Tony Mulhern,7,3,4
133207947,Jake Richardson,426009127,Bav Patel,7,3,4
133207947,Jake Richardson,523395206,Jamie Lashmar,7,3,4
133207947,Jake Richardson,646410961,Paul Scorer,7,2,5
174147986,Lee Cliff,411473516,Ray Canham,7,4,3
225850882,John McLellan,836895047,Ian McKay,7,4,3
229719541,Scott Manning,613893140,Matt Warner,7,7,0
278731588,Lester Grice,426009127,Bav Patel,7,4,3
278731588,Lester Grice,617751649,Lee Simpson,7,2,5
278731588,Lester Grice,809568302,Mark Johnson,7,3,4
323907964,Russ Hughes,646410961,Paul Scorer,7,3,4
345558874,Zack Richardson,523395206,Jamie Lashmar,7,4,3
384960657,Dave Lewney,428102632,Anthony Flynn,7,4,3
384960657,Dave Lewney,802242736,Steve Hughes,7,4,3
426009127,Bav Patel,754250007,Freddie Blunden,7,5,2
444350794,Richard Freeman,889234854,Paul Smith,7,3,4
484159049,Tommy Wright,732415457,Barry Hall,7,5,2
506581042,Glen Dartnell,617751649,Lee Simpson,7,2,5
523395206,Jamie Lashmar,670256222,Connor Anderson,7,5,2
523395206,Jamie Lashmar,963958265,Rodney Moogan,7,7,0
617751649,Lee Simpson,794630189,Mark Coles,7,6,1
802242736,Steve Hughes,963958265,Rodney Moogan,7,4,3
809568302,Mark Johnson,825399596,Pat Adams,7,2,5
809647573,John Taylor,974385564,Danny Booker,7,1,6
833156731,Jez Saunders,970786910,Kevin Sorrell,7,0,7
858283721,Dave Dunstall,963206772,Dean Moore,7,4,3
61,Paul Gander,279543944,Peter Maurice,6,3,3
65,Paul Hudson,202090738,Alan Head,6,5,1
80,Dave Wells,649240057,Mike Childs,6,4,2
149,Tony Nealgrove,179,Mick Jones,6,1,5
179,Mick Jones,732415457,Barry Hall,6,3,3
180,Pat Sweeney,278,Dave Fairbairn,6,4,2
183,Simon Alexander,480154054,Jim Dunstall,6,5,1
440,Gordon Carter,845758589,Charlie James,6,4,2
11133032,Simon Dent,809568302,Mark Johnson,6,4,2
32061370,Toby Prince-Iles,294944526,Rob Teanby,6,3,3
34787509,Dave McCarthy,426009127,Bav Patel,6,5,1
34787509,Dave McCarthy,752709358,Chris Mason,6,4,2
39289507,Mick Laughlin,674307680,Neil McCafferty,6,5,1
41098823,Mikey Booker,258340682,John Derret,6,2,4
41461520,Luke Pooley,567624732,Dave Brampton,6,0,6
41461520,Luke Pooley,649240057,Mike Childs,6,3,3
59858690,James Constable,748064029,Paul Hughes,6,3,3
59858690,James Constable,809568302,Mark Johnson,6,3,3
60575249,Ash Thurmer,428102632,Anthony Flynn,6,2,4
70159035,Peter Rea,831214643,Tony Shipley,6,5,1
96103077,Paul Norris,96354463,Rob Pickard,6,6,0
96103077,Paul Norris,345558874,Zack Richardson,6,1,5
96103077,Paul Norris,426009127,Bav Patel,6,5,1
96103077,Paul Norris,963958265,Rodney Moogan,6,6,0
96354463,Rob Pickard,646410961,Paul Scorer,6,2,4
96354463,Rob Pickard,948504778,Jon Fordham,6,5,1
96354463,Rob Pickard,963958265,Rodney Moogan,6,4,2
112887737,Pip Akehurst,225850882,John McLellan,6,6,0
112887737,Pip Akehurst,719124015,Tony Power,6,5,1
124523642,Tom Hayes,732415457,Barry Hall,6,2,4
133207947,Jake Richardson,278731588,Lester Grice,6,4,2
133207947,Jake Richardson,670256222,Connor Anderson,6,2,4
133207947,Jake Richardson,748064029,Paul Hughes,6,4,2
133207947,Jake Richardson,957784480,Harry Banks,6,4,2
229719541,Scott Manning,279543944,Peter Maurice,6,6,0
229719541,Scott Manning,820231590,Alan Rook,6,6,0
231445676,Tony Paice,567316488,Lee Millyard,6,2,4
275738778,John Da Silva,899206834,Jez Downs,6,4,2
278731588,Lester Grice,646410961,Paul Scorer,6,1,5
278731588,Lester Grice,948504778,Jon Fordham,6,4,2
307140835,Tony Strange,802242736,Steve Hughes,6,5,1
384960657,Dave Lewney,963958265,Rodney Moogan,6,6,0
386517733,Ady Halley,567624732,Dave Brampton,6,3,3
394906196,Mick Mabbitt,430890681,Malcolm Cooper,6,1,5
394906196,Mick Mabbitt,612265840,Paul Honeysett,6,4,2
412256116,Andy Sutton,574248035,Tony Mulhern,6,1,5
426009127,Bav Patel,617751649,Lee Simpson,6,2,4
428102632,Anthony Flynn,515186402,Ben Evans,6,1,5
428102632,Anthony Flynn,754250007,Freddie Blunden,6,2,4
428102632,Anthony Flynn,865803068,Dave Jones,6,3,3
428102632,Anthony Flynn,948504778,Jon Fordham,6,4,2
436708540,Bob Henley,490170224,Jamie Matthews,6,0,6
484159049,Tommy Wright,800114325,Roger Whiteley,6,2,4
490170224,Jamie Matthews,800114325,Roger Whiteley,6,2,4
523395206,Jamie Lashmar,662568995,Rob Wykes,6,5,1
523395206,Jamie Lashmar,809568302,Mark Johnson,6,5,1
535728699,Fred Cooper,688252012,Sean Cooper,6,5,1
537640521,Ian Stoner,704007508,Alan Muir,6,2,4
619390728,Steve Stylianou,748064029,Paul Hughes,6,4,2
619390728,Steve Stylianou,809568302,Mark Johnson,6,2,4
670256222,Connor Anderson,748064029,Paul Hughes,6,5,1
670256222,Connor Anderson,766684900,John Gillard,6,4,2
670256222,Connor Anderson,825399596,Pat Adams,6,4,2
670256222,Connor Anderson,963958265,Rodney Moogan,6,5,1
688778183,Dean Paice,831214643,Tony Shipley,6,3,3
717256135,Trevor Pickard,836895047,Ian McKay,6,1,5
721321839,Matt Peake,949603489,Pete Bennett,6,3,3
733453947,Phil Canham,970786910,Kevin Sorrell,6,1,5
745152759,Kevin Jewell,943667183,John Stone,6,0,6
752709358,Chris Mason,794630189,Mark Coles,6,3,3
766684900,John Gillard,802242736,Steve Hughes,6,6,0
809647573,John Taylor,889234854,Paul Smith,6,3,3
809984729,Neil Scutt,929636592,Danny Wilson,6,4,2
815023707,David Senior,820231590,Alan Rook,6,2,4
966905561,Tony Dade,978156264,Bob Paine,6,4,2
14,Michael West,323907964,Russ Hughes,5,3,2
61,Paul Gander,800114325,Roger Whiteley,5,3,2
65,Paul Hudson,395,Herby Burchell,5,2,3
65,Paul Hudson,688778183,Dean Paice,5,0,5
76,David Rea,231975313,Danny English,5,2,3
88,Steve Collins,717256135,Trevor Pickard,5,0,5
98,Tony Collins,319057545,Brendan Lambe,5,2,3
98,Tony Collins,746406369,Loz O'Keefe,5,2,3
98,Tony Collins,845758589,Charlie James,5,4,1
121,Mike Barnett,171346729,Des Heasman,5,1,4
124,Dave Tristram,173,Dave Alderton,5,3,2
124,Dave Tristram,574248035,Tony Mulhern,5,2,3
179,Mick Jones,970786910,Kevin Sorrell,5,1,4
247,Mick Justice,316,Paul Redgate,5,4,1
278,Dave Fairbairn,669385277,Steve Towler,5,2,3
284,Ray Bradley,966905561,Tony Dade,5,1,4
301,Terry Grant,506320151,Frank Taylor,5,1,4
309,M. Humphries,275738778,John Da Silva,5,4,1
3508579,John Murray,436708540,Bob Henley,5,1,4
3508579,John Murray,574248035,Tony Mulhern,5,1,4
11133032,Simon Dent,307140835,Tony Strange,5,2,3
11133032,Simon Dent,646410961,Paul Scorer,5,4,1
11133032,Simon Dent,670256222,Connor Anderson,5,3,2
11133032,Simon Dent,754250007,Freddie Blunden,5,4,1
11133032,Simon Dent,957784480,Harry Banks,5,5,0
16253983,Tony Simmonds,326342962,Geoff Randall,5,4,1
16253983,Tony Simmonds,670034050,John Muzio,5,5,0
16253983,Tony Simmonds,732415457,Barry Hall,5,5,0
16253983,Tony Simmonds,800114325,Roger Whiteley,5,2,3
16253983,Tony Simmonds,858283721,Dave Dunstall,5,4,1
16253983,Tony Simmonds,974385564,Danny Booker,5,3,2
26970170,Kai Michael,96354463,Rob Pickard,5,1,4
26970170,Kai Michael,278731588,Lester Grice,5,2,3
26970170,Kai Michael,428102632,Anthony Flynn,5,2,3
26970170,Kai Michael,809568302,Mark Johnson,5,2,3
26970170,Kai Michael,948504778,Jon Fordham,5,1,4
32061370,Toby Prince-Iles,535728699,Fred Cooper,5,2,3
32061370,Toby Prince-Iles,613893140,Matt Warner,5,2,3
32061370,Toby Prince-Iles,971308746,Clive Harman,5,1,4
34787509,Dave McCarthy,278731588,Lester Grice,5,3,2
34787509,Dave McCarthy,307140835,Tony Strange,5,0,5
34787509,Dave McCarthy,754250007,Freddie Blunden,5,3,2
34787509,Dave McCarthy,957784480,Harry Banks,5,1,4
39289507,Mick Laughlin,101751030,Simon Uddin,5,3,2
39289507,Mick Laughlin,613893140,Matt Warner,5,0,5
41098823,Mikey Booker,326342962,Geoff Randall,5,2,3
41461520,Luke Pooley,279543944,Peter Maurice,5,1,4
59858690,James Constable,666735933,Mike Collier,5,1,4
59858690,James Constable,752709358,Chris Mason,5,0,5
60575249,Ash Thurmer,90176364,David Page,5,3,2
60575249,Ash Thurmer,797962517,Dave Lewis,5,2,3
60575249,Ash Thurmer,802242736,Steve Hughes,5,4,1
60575249,Ash Thurmer,963958265,Rodney Moogan,5,1,4
70159035,Peter Rea,223983583,Carl Wentworth,5,5,0
70159035,Peter Rea,567624732,Dave Brampton,5,4,1
76011459,Kane Harman,271464632,Paul Phillips,5,2,3
96103077,Paul Norris,506581042,Glen Dartnell,5,4,1
96103077,Paul Norris,748064029,Paul Hughes,5,5,0
96103077,Paul Norris,754250007,Freddie Blunden,5,3,2
96103077,Paul Norris,957784480,Harry Banks,5,3,2
96354463,Rob Pickard,133207947,Jake Richardson,5,4,1
96354463,Rob Pickard,428102632,Anthony Flynn,5,4,1
96354463,Rob Pickard,506581042,Glen Dartnell,5,3,2
96354463,Rob Pickard,666735933,Mike Collier,5,1,4
112887737,Pip Akehurst,954080507,Sam Corsby,5,3,2
114184042,Ian Smith,124523642,Tom Hayes,5,1,4
120138229,Adam Butler,889234854,Paul Smith,5,4,1
120138229,Adam Butler,949603489,Pete Bennett,5,5,0
133207947,Jake Richardson,428102632,Anthony Flynn,5,4,1
133207947,Jake Richardson,754250007,Freddie Blunden,5,1,4
133207947,Jake Richardson,797962517,Dave Lewis,5,2,3
144293731,Simon Parry,954297832,Pav Sareen,5,3,2
160950731,Locky McCurdy,394906196,Mick Mabbitt,5,2,3
160950731,Locky McCurdy,612265840,Paul Honeysett,5,5,0
171346729,Des Heasman,386517733,Ady Halley,5,3,2
171346729,Des Heasman,394906196,Mick Mabbitt,5,5,0
171346729,Des Heasman,856755662,David Marsh,5,0,5
172646809,Robin Powell,279543944,Peter Maurice,5,2,3
174147986,Lee Cliff,360777082,Mark Bishop,5,4,1
174147986,Lee Cliff,444350794,Richard Freeman,5,5,0
174147986,Lee Cliff,845758589,Charlie James,5,4,1
223983583,Carl Wentworth,943667183,John Stone,5,2,3
223983583,Carl Wentworth,953512654,Les Berry,5,1,4
225850882,John McLellan,412256116,Andy Sutton,5,4,1
225850882,John McLellan,848997254,Tom Parker,5,1,4
229719541,Scott Manning,490170224,Jamie Matthews,5,4,1
229719541,Scott Manning,688252012,Sean Cooper,5,5,0
266477517,Tony Baxter,567624732,Dave Brampton,5,0,5
266591683,Chris Roche,719124015,Tony Power,5,5,0
278731588,Lester Grice,567316488,Lee Millyard,5,2,3
279543944,Peter Maurice,573567936,Steve Marriott,5,1,4
279543944,Peter Maurice,820231590,Alan Rook,5,5,0
279543944,Peter Maurice,845758589,Charlie James,5,2,3
291816585,Jim Somers,349269645,Barry Thornton,5,2,3
291816585,Jim Somers,943667183,John Stone,5,0,5
293577764,Dave Crosskey,820231590,Alan Rook,5,1,4
293577764,Dave Crosskey,873916947,Geoff Akehurst,5,2,3
293577764,Dave Crosskey,943667183,John Stone,5,4,1
301960429,Brian Collins,936624299,Peter Gallant,5,4,1
306438070,Martin Stocker,436708540,Bob Henley,5,5,0
307140835,Tony Strange,345558874,Zack Richardson,5,2,3
307140835,Tony Strange,666735933,Mike Collier,5,2,3
307140835,Tony Strange,748064029,Paul Hughes,5,4,1
307140835,Tony Strange,754250007,Freddie Blunden,5,1,4
307140835,Tony Strange,766684900,John Gillard,5,1,4
323907964,Russ Hughes,617751649,Lee Simpson,5,3,2
341869673,Nigel Stilwell,646410961,Paul Scorer,5,1,4
345558874,Zack Richardson,766684900,John Gillard,5,4,1
345558874,Zack Richardson,957784480,Harry Banks,5,4,1
349269645,Barry Thornton,360777082,Mark Bishop,5,2,3
349269645,Barry Thornton,936624299,Peter Gallant,5,4,1
351143642,Michael Palmer,386517733,Ady Halley,5,3,2
351143642,Michael Palmer,417786644,Eddie Collins,5,3,2
351143642,Michael Palmer,943667183,John Stone,5,1,4
356397577,David Morgan,957784480,Harry Banks,5,4,1
360777082,Mark Bishop,922772801,Nick Buonanno,5,1,4
384960657,Dave Lewney,600385553,Darren Welfare,5,4,1
384960657,Dave Lewney,748064029,Paul Hughes,5,2,3
384960657,Dave Lewney,797962517,Dave Lewis,5,4,1
384960657,Dave Lewney,876526526,Ash Bull,5,2,3
384960657,Dave Lewney,948504778,Jon Fordham,5,4,1
386517733,Ady Halley,417786644,Eddie Collins,5,4,1
386517733,Ady Halley,480154054,Jim Dunstall,5,4,1
386517733,Ady Halley,495939788,Tyrone Davis,5,4,1
386517733,Ady Halley,529382351,Greg Foat,5,5,0
392533233,Jack Wright,831214643,Tony Shipley,5,1,4
394906196,Mick Mabbitt,867613624,Ian Dunhill,5,0,5
411473516,Ray Canham,866506631,Mark Smith,5,3,2
412256116,Andy Sutton,717256135,Trevor Pickard,5,2,3
423038309,Ian Fennell,954080507,Sam Corsby,5,4,1
426009127,Bav Patel,428102632,Anthony Flynn,5,1,4
426009127,Bav Patel,523395206,Jamie Lashmar,5,1,4
426009127,Bav Patel,662568995,Rob Wykes,5,3,2
426009127,Bav Patel,670256222,Connor Anderson,5,1,4
428102632,Anthony Flynn,523395206,Jamie Lashmar,5,0,5
428102632,Anthony Flynn,619390728,Steve Stylianou,5,4,1
428102632,Anthony Flynn,957784480,Harry Banks,5,3,2
436708540,Bob Henley,506320151,Frank Taylor,5,2,3
436708540,Bob Henley,836895047,Ian McKay,5,3,2
436708540,Bob Henley,873916947,Geoff Akehurst,5,2,3
444339215,Steve Richards,820231590,Alan Rook,5,4,1
455401154,Kai Ellis,574248035,Tony Mulhern,5,4,1
463709832,Danny Wong,688778183,Dean Paice,5,3,2
463709832,Danny Wong,954297832,Pav Sareen,5,1,4
480154054,Jim Dunstall,669385277,Steve Towler,5,0,5
484159049,Tommy Wright,867613624,Ian Dunhill,5,4,1
490170224,Jamie Matthews,899206834,Jez Downs,5,4,1
493830161,Luke Strevens,867613624,Ian Dunhill,5,4,1
506581042,Glen Dartnell,646410961,Paul Scorer,5,1,4
515186402,Ben Evans,617751649,Lee Simpson,5,3,2
515186402,Ben Evans,809568302,Mark Johnson,5,4,1
523395206,Jamie Lashmar,802242736,Steve Hughes,5,4,1
523395206,Jamie Lashmar,825399596,Pat Adams,5,3,2
523395206,Jamie Lashmar,957784480,Harry Banks,5,4,1
535728699,Fred Cooper,845758589,Charlie James,5,3,2
556095121,Tom Wright,649240057,Mike Childs,5,3,2
567624732,Dave Brampton,936624299,Peter Gallant,5,4,1
567624732,Dave Brampton,953512654,Les Berry,5,3,2
573567936,Steve Marriott,936624299,Peter Gallant,5,3,2
608140548,David Gillingham,836895047,Ian McKay,5,4,1
612265840,Paul Honeysett,936624299,Peter Gallant,5,2,3
613893140,Matt Warner,724342701,Nigel Lilley,5,2,3
619390728,Steve Stylianou,666735933,Mike Collier,5,1,4
646410961,Paul Scorer,662568995,Rob Wykes,5,4,1
646410961,Paul Scorer,666735933,Mike Collier,5,2,3
646410961,Paul Scorer,754250007,Freddie Blunden,5,1,4
646410961,Paul Scorer,809568302,Mark Johnson,5,3,2
646410961,Paul Scorer,948504778,Jon Fordham,5,3,2
646410961,Paul Scorer,954297832,Pav Sareen,5,3,2
649240057,Mike Childs,820231590,Alan Rook,5,2,3
662568995,Rob Wykes,802242736,Steve Hughes,5,3,2
662568995,Rob Wykes,825399596,Pat Adams,5,2,3
666735933,Mike Collier,802242736,Steve Hughes,5,4,1
669385277,Steve Towler,724342701,Nigel Lilley,5,1,4
670034050,John Muzio,717256135,Trevor Pickard,5,1,4
670034050,John Muzio,721321839,Matt Peake,5,4,1
670034050,John Muzio,949603489,Pete Bennett,5,0,5
670256222,Connor Anderson,754250007,Freddie Blunden,5,2,3
688778183,Dean Paice,704007508,Alan Muir,5,4,1
732321233,Nathan Brooks,802242736,Steve Hughes,5,2,3
748064029,Paul Hughes,957784480,Harry Banks,5,4,1
748064029,Paul Hughes,963958265,Rodney Moogan,5,4,1
752709358,Chris Mason,809788967,Brett Williams,5,5,0
752709358,Chris Mason,957784480,Harry Banks,5,4,1
754250007,Freddie Blunden,963958265,Rodney Moogan,5,5,0
766684900,John Gillard,963958265,Rodney Moogan,5,5,0
800114325,Roger Whiteley,974385564,Danny Booker,5,1,4
802242736,Steve Hughes,850059806,Heng Wong,5,4,1
809568302,Mark Johnson,948504778,Jon Fordham,5,4,1
831214643,Tony Shipley,836895047,Ian McKay,5,2,3
831214643,Tony Shipley,936624299,Peter Gallant,5,4,1
833156731,Jez Saunders,845758589,Charlie James,5,2,3
858283721,Dave Dunstall,970786910,Kevin Sorrell,5,2,3
866506631,Mark Smith,963206772,Dean Moore,5,2,3
954080507,Sam Corsby,974385564,Danny Booker,5,3,2
957784480,Harry Banks,963958265,Rodney Moogan,5,2,3
3,Neal Gozzett,223,Ollie Stalley,4,2,2
6,Dan Stirling,365,Dan Buckwell,4,3,1
6,Dan Stirling,523395206,Jamie Lashmar,4,1,3
9,Michael Cheung,307140835,Tony Strange,4,0,4
16,Mick Beck,503528426,Larry Maloney,4,4,0
65,Paul Hudson,114184042,Ian Smith,4,2,2
76,David Rea,179,Mick Jones,4,1,3
76,David Rea,600385553,Darren Welfare,4,1,3
84,Gavin McCubbin,448,Adam Bradshaw,4,2,2
89,Mike Atkins,278731588,Lester Grice,4,4,0
92,Dale Thomas,183,Simon Alexander,4,1,3
96,Dave Kellett,844676925,Kieran Williams,4,2,2
97,Shaun Winsor,844676925,Kieran Williams,4,2,2
108,John Wooller,831214643,Tony Shipley,4,0,4
121,Mike Barnett,174,Brian Grant,4,0,4
121,Mike Barnett,319,John Lojo,4,3,1
121,Mike Barnett,412256116,Andy Sutton,4,1,3
124,Dave Tristram,177,John Regan,4,1,3
124,Dave Tristram,412256116,Andy Sutton,4,0,4
124,Dave Tristram,901024459,Paul Charman,4,4,0
149,Tony Nealgrove,480154054,Jim Dunstall,4,2,2
153,Tony Leach,436708540,Bob Henley,4,1,3
173,Dave Alderton,845537273,Dave Gridley,4,1,3
177,John Regan,225850882,John McLellan,4,0,4
179,Mick Jones,199,Mark Holloway,4,3,1
179,Mick Jones,124523642,Tom Hayes,4,1,3
179,Mick Jones,805165161,Steve Owen,4,1,3
180,Pat Sweeney,174147986,Lee Cliff,4,3,1
180,Pat Sweeney,669385277,Steve Towler,4,4,0
181,Dave Roughley,307,Alister Morrison,4,2,2
181,Dave Roughley,386517733,Ady Halley,4,3,1
182,Brian Welfare,202,Bob Firth,4,2,2
182,Brian Welfare,866506631,Mark Smith,4,2,2
183,Simon Alexander,225247539,Barry Knight,4,2,2
183,Simon Alexander,386517733,Ady Halley,4,4,0
183,Simon Alexander,573567936,Steve Marriott,4,2,2
199,Mark Holloway,174147986,Lee Cliff,4,1,3
202,Bob Firth,873916947,Geoff Akehurst,4,3,1
235,Derek Conley,266591683,Chris Roche,4,0,4
235,Derek Conley,503528426,Larry Maloney,4,3,1
239,Mick Lucas,279,Tony Slark,4,3,1
239,Mick Lucas,246154671,Alan Gunn,4,1,3
278,Dave Fairbairn,858283721,Dave Dunstall,4,1,3
278,Dave Fairbairn,915035871,Kevin Graysmark,4,2,2
315,Peter Stevens,579164381,Danny Cattell,4,2,2
365,Dan Buckwell,5820499,Paul Bartlett,4,4,0
365,Dan Buckwell,666735933,Mike Collier,4,2,2
384,Bryan Beck,978156264,Bob Paine,4,3,1
394,Alan Burchell,266591683,Chris Roche,4,3,1
403,Joe Marcuson,745152759,Kevin Jewell,4,2,2
440,Gordon Carter,101751030,Simon Uddin,4,1,3
440,Gordon Carter,160950731,Locky McCurdy,4,1,3
440,Gordon Carter,922772801,Nick Buonanno,4,1,3
11133032,Simon Dent,278731588,Lester Grice,4,4,0
11133032,Simon Dent,766684900,John Gillard,4,3,1
11133032,Simon Dent,794630189,Mark Coles,4,1,3
11133032,Simon Dent,802242736,Steve Hughes,4,3,1
11133032,Simon Dent,963958265,Rodney Moogan,4,3,1
16253983,Tony Simmonds,327948141,Ross Etheridge,4,3,1
26970170,Kai Michael,523395206,Jamie Lashmar,4,1,3
26970170,Kai Michael,567316488,Lee Millyard,4,3,1
26970170,Kai Michael,754250007,Freddie Blunden,4,0,4
26970170,Kai Michael,797962517,Dave Lewis,4,1,3
26970170,Kai Michael,802242736,Steve Hughes,4,2,2
26970170,Kai Michael,963958265,Rodney Moogan,4,3,1
28382047,Steve Harrington,229719541,Scott Manning,4,0,4
28382047,Steve Harrington,537640521,Ian Stoner,4,3,1
28382047,Steve Harrington,844676925,Kieran Williams,4,2,2
32061370,Toby Prince-Iles,39289507,Mick Laughlin,4,0,4
32061370,Toby Prince-Iles,160950731,Locky McCurdy,4,4,0
32061370,Toby Prince-Iles,349269645,Barry Thornton,4,2,2
32061370,Toby Prince-Iles,498330760,Mo Collins,4,3,1
32061370,Toby Prince-Iles,688252012,Sean Cooper,4,2,2
32061370,Toby Prince-Iles,704007508,Alan Muir,4,1,3
32061370,Toby Prince-Iles,910809545,Blake Harman,4,1,3
32061370,Toby Prince-Iles,966905561,Tony Dade,4,2,2
34787509,Dave McCarthy,96354463,Rob Pickard,4,1,3
34787509,Dave McCarthy,523395206,Jamie Lashmar,4,0,4
34787509,Dave McCarthy,646410961,Paul Scorer,4,4,0
39289507,Mick Laughlin,966905561,Tony Dade,4,1,3
41098823,Mikey Booker,124523642,Tom Hayes,4,3,1
41461520,Luke Pooley,386517733,Ady Halley,4,1,3
56252722,Dave Pither,490170224,Jamie Matthews,4,1,3
59858690,James Constable,60575249,Ash Thurmer,4,1,3
59858690,James Constable,96354463,Rob Pickard,4,2,2
60575249,Ash Thurmer,326342962,Geoff Randall,4,2,2
60575249,Ash Thurmer,506581042,Glen Dartnell,4,2,2
60575249,Ash Thurmer,948504778,Jon Fordham,4,2,2
69745818,Ian Bowles,411473516,Ray Canham,4,0,4
70159035,Peter Rea,426236650,Dave Parrott,4,4,0
70159035,Peter Rea,953512654,Les Berry,4,4,0
70159035,Peter Rea,966905561,Tony Dade,4,4,0
70159035,Peter Rea,978156264,Bob Paine,4,4,0
96103077,Paul Norris,384960657,Dave Lewney,4,4,0
96103077,Paul Norris,515186402,Ben Evans,4,2,2
96103077,Paul Norris,523395206,Jamie Lashmar,4,4,0
96354463,Rob Pickard,754250007,Freddie Blunden,4,1,3
110039677,Mick Miller,171346729,Des Heasman,4,2,2
110039677,Mick Miller,174147986,Lee Cliff,4,2,2
112887737,Pip Akehurst,323907964,Russ Hughes,4,1,3
112887737,Pip Akehurst,326342962,Geoff Randall,4,1,3
112887737,Pip Akehurst,412256116,Andy Sutton,4,3,1
112887737,Pip Akehurst,574248035,Tony Mulhern,4,4,0
112887737,Pip Akehurst,721321839,Matt Peake,4,4,0
112887737,Pip Akehurst,836895047,Ian McKay,4,4,0
114184042,Ian Smith,202090738,Alan Head,4,3,1
114184042,Ian Smith,412256116,Andy Sutton,4,2,2
114184042,Ian Smith,717256135,Trevor Pickard,4,1,3
114319292,Oliver Gorrod,484159049,Tommy Wright,4,0,4
114319292,Oliver Gorrod,833156731,Jez Saunders,4,2,2
123792666,Jamie Thomas,319057545,Brendan Lambe,4,4,0
123792666,Jamie Thomas,728690686,Rick Rothschild,4,3,1
124523642,Tom Hayes,963206772,Dean Moore,4,3,1
133207947,Jake Richardson,390364577,Mark Bright,4,0,4
133207947,Jake Richardson,662568995,Rob Wykes,4,2,2
133207947,Jake Richardson,752709358,Chris Mason,4,1,3
133207947,Jake Richardson,802242736,Steve Hughes,4,3,1
133207947,Jake Richardson,809568302,Mark Johnson,4,2,2
133207947,Jake Richardson,947143243,Chris Davis,4,4,0
144293731,Simon Parry,809568302,Mark Johnson,4,2,2
146404254,Randall Griffiths,394906196,Mick Mabbitt,4,3,1
146404254,Randall Griffiths,899206834,Jez Downs,4,2,2
160950731,Locky McCurdy,719124015,Tony Power,4,2,2
171346729,Des Heasman,455401154,Kai Ellis,4,2,2
171346729,Des Heasman,901024459,Paul Charman,4,2,2
172646809,Robin Powell,804381932,Ryan Harman,4,3,1
174147986,Lee Cliff,319057545,Brendan Lambe,4,3,1
174147986,Lee Cliff,382970973,Paul Shaw,4,1,3
192463126,Gerry Lindsey,948504778,Jon Fordham,4,0,4
213264678,Martin Hall,954080507,Sam Corsby,4,1,3
216787426,Jack Perrin,845758589,Charlie James,4,3,1
223983583,Carl Wentworth,936624299,Peter Gallant,4,2,2
225247539,Barry Knight,275738778,John Da Silva,4,1,3
225247539,Barry Knight,719124015,Tony Power,4,1,3
225247539,Barry Knight,873916947,Geoff Akehurst,4,0,4
225850882,John McLellan,436708540,Bob Henley,4,3,1
225850882,John McLellan,608140548,David Gillingham,4,0,4
225850882,John McLellan,717256135,Trevor Pickard,4,1,3
225850882,John McLellan,719124015,Tony Power,4,3,1
225850882,John McLellan,954080507,Sam Corsby,4,3,1
227209116,Peter Rawlinson,978156264,Bob Paine,4,4,0
229719541,Scott Manning,922772801,Nick Buonanno,4,4,0
229719541,Scott Manning,951468676,Steve Burchett,4,4,0
231445676,Tony Paice,293577764,Dave Crosskey,4,2,2
231445676,Tony Paice,820231590,Alan Rook,4,4,0
266477517,Tony Baxter,293577764,Dave Crosskey,4,0,4
266477517,Tony Baxter,649240057,Mike Childs,4,4,0
266477517,Tony Baxter,746406369,Loz O'Keefe,4,0,4
266477517,Tony Baxter,978156264,Bob Paine,4,4,0
266591683,Chris Roche,800114325,Roger Whiteley,4,0,4
266591683,Chris Roche,836895047,Ian McKay,4,2,2
271464632,Paul Phillips,613893140,Matt Warner,4,3,1
278731588,Lester Grice,529382351,Greg Foat,4,4,0
278731588,Lester Grice,561171273,Andy Norman,4,0,4
278731588,Lester Grice,748064029,Paul Hughes,4,3,1
278731588,Lester Grice,766684900,John Gillard,4,0,4
278731588,Lester Grice,825399596,Pat Adams,4,0,4
278731588,Lester Grice,963958265,Rodney Moogan,4,4,0
279543944,Peter Maurice,567316488,Lee Millyard,4,2,2
279543944,Peter Maurice,800114325,Roger Whiteley,4,0,4
289915561,Craig Dummer,341869673,Nigel Stilwell,4,2,2
291816585,Jim Somers,411473516,Ray Canham,4,1,3
291816585,Jim Somers,529382351,Greg Foat,4,0,4
291816585,Jim Somers,831214643,Tony Shipley,4,0,4
293577764,Dave Crosskey,495939788,Tyrone Davis,4,4,0
293577764,Dave Crosskey,978156264,Bob Paine,4,3,1
294944526,Rob Teanby,978156264,Bob Paine,4,4,0
301960429,Brian Collins,670034050,John Muzio,4,4,0
301960429,Brian Collins,688778183,Dean Paice,4,3,1
307140835,Tony Strange,809568302,Mark Johnson,4,3,1
319057545,Brendan Lambe,360777082,Mark Bishop,4,1,3
319057545,Brendan Lambe,728690686,Rick Rothschild,4,2,2
319057545,Brendan Lambe,732415457,Barry Hall,4,2,2
323907964,Russ Hughes,608140548,David Gillingham,4,1,3
323907964,Russ Hughes,619390728,Steve Stylianou,4,2,2
323907964,Russ Hughes,754250007,Freddie Blunden,4,1,3
323907964,Russ Hughes,766684900,John Gillard,4,2,2
323907964,Russ Hughes,797962517,Dave Lewis,4,4,0
326342962,Geoff Randall,719124015,Tony Power,4,3,1
326342962,Geoff Randall,954080507,Sam Corsby,4,2,2
327948141,Ross Etheridge,412256116,Andy Sutton,4,3,1
327948141,Ross Etheridge,535728699,Fred Cooper,4,3,1
327948141,Ross Etheridge,880982797,Ray Hunter,4,2,2
341869673,Nigel Stilwell,523395206,Jamie Lashmar,4,0,4
345558874,Zack Richardson,600385553,Darren Welfare,4,3,1
345558874,Zack Richardson,748064029,Paul Hughes,4,4,0
345558874,Zack Richardson,963958265,Rodney Moogan,4,4,0
349269645,Barry Thornton,411473516,Ray Canham,4,1,3
349269645,Barry Thornton,529382351,Greg Foat,4,2,2
349269645,Barry Thornton,537640521,Ian Stoner,4,2,2
349269645,Barry Thornton,612265840,Paul Honeysett,4,4,0
351143642,Michael Palmer,936624299,Peter Gallant,4,1,3
356397577,David Morgan,617751649,Lee Simpson,4,1,3
356397577,David Morgan,646410961,Paul Scorer,4,2,2
356397577,David Morgan,748064029,Paul Hughes,4,2,2
360777082,Mark Bishop,833156731,Jez Saunders,4,3,1
364867274,Dave Lucking,436708540,Bob Henley,4,2,2
384960657,Dave Lewney,561171273,Andy Norman,4,1,3
386517733,Ady Halley,713064363,John Trory,4,3,1
392533233,Jack Wright,809984729,Neil Scutt,4,3,1
394906196,Mick Mabbitt,733453947,Phil Canham,4,0,4
394906196,Mick Mabbitt,833156731,Jez Saunders,4,1,3
394906196,Mick Mabbitt,899206834,Jez Downs,4,0,4
394906196,Mick Mabbitt,963206772,Dean Moore,4,0,4
402257815,Jim Cumming,598846718,Ben Sorrell,4,1,3
409212679,Mark Chapman,773216781,Sean Payne,4,0,4
409212679,Mark Chapman,866506631,Mark Smith,4,2,2
409212679,Mark Chapman,889234854,Paul Smith,4,1,3
409212679,Mark Chapman,970786910,Kevin Sorrell,4,0,4
411473516,Ray Canham,430890681,Malcolm Cooper,4,2,2
411473516,Ray Canham,970786910,Kevin Sorrell,4,1,3
412256116,Andy Sutton,444350794,Richard Freeman,4,3,1
412256116,Andy Sutton,654650203,Alan O'Sullivan,4,0,4
415524562,Dave King,501266206,David Fox,4,4,0
417786644,Eddie Collins,713064363,John Trory,4,1,3
423038309,Ian Fennell,974385564,Danny Booker,4,1,3
426009127,Bav Patel,748064029,Paul Hughes,4,1,3
426009127,Bav Patel,809568302,Mark Johnson,4,3,1
426009127,Bav Patel,954297832,Pav Sareen,4,3,1
428102632,Anthony Flynn,506581042,Glen Dartnell,4,3,1
428102632,Anthony Flynn,766684900,John Gillard,4,2,2
430890681,Malcolm Cooper,788605510,Mark Rose,4,3,1
430890681,Malcolm Cooper,936624299,Peter Gallant,4,1,3
436708540,Bob Henley,574248035,Tony Mulhern,4,1,3
436708540,Bob Henley,670034050,John Muzio,4,3,1
444639447,Andy Wong,802242736,Steve Hughes,4,3,1
455401154,Kai Ellis,641692362,Bob Taylor,4,3,1
455401154,Kai Ellis,670256222,Connor Anderson,4,1,3
484159049,Tommy Wright,535728699,Fred Cooper,4,2,2
484159049,Tommy Wright,949603489,Pete Bennett,4,0,4
490170224,Jamie Matthews,574248035,Tony Mulhern,4,3,1
490170224,Jamie Matthews,951468676,Steve Burchett,4,2,2
493830161,Luke Strevens,732415457,Barry Hall,4,2,2
495939788,Tyrone Davis,688778183,Dean Paice,4,0,4
501266206,David Fox,845758589,Charlie James,4,2,2
503528426,Larry Maloney,529382351,Greg Foat,4,4,0
506581042,Glen Dartnell,748064029,Paul Hughes,4,2,2
506581042,Glen Dartnell,963958265,Rodney Moogan,4,3,1
515186402,Ben Evans,523395206,Jamie Lashmar,4,1,3
515186402,Ben Evans,748064029,Paul Hughes,4,2,2
523395206,Jamie Lashmar,619390728,Steve Stylianou,4,2,2
523395206,Jamie Lashmar,746406369,Loz O'Keefe,4,3,1
523395206,Jamie Lashmar,794630189,Mark Coles,4,2,2
529382351,Greg Foat,688778183,Dean Paice,4,0,4
529382351,Greg Foat,978156264,Bob Paine,4,2,2
535728699,Fred Cooper,688778183,Dean Paice,4,0,4
535728699,Fred Cooper,732415457,Barry Hall,4,1,3
535728699,Fred Cooper,910809545,Blake Harman,4,1,3
535728699,Fred Cooper,953512654,Les Berry,4,4,0
537640521,Ian Stoner,613893140,Matt Warner,4,1,3
537640521,Ian Stoner,971308746,Clive Harman,4,3,1
556095121,Tom Wright,688252012,Sean Cooper,4,2,2
567316488,Lee Millyard,800114325,Roger Whiteley,4,0,4
567316488,Lee Millyard,831214643,Tony Shipley,4,0,4
573567936,Steve Marriott,943667183,John Stone,4,2,2
573567936,Steve Marriott,953512654,Les Berry,4,3,1
573567936,Steve Marriott,971308746,Clive Harman,4,1,3
574248035,Tony Mulhern,608140548,David Gillingham,4,1,3
574248035,Tony Mulhern,670034050,John Muzio,4,2,2
574248035,Tony Mulhern,836895047,Ian McKay,4,2,2
574248035,Tony Mulhern,954080507,Sam Corsby,4,2,2
600385553,Darren Welfare,800114325,Roger Whiteley,4,3,1
608140548,David Gillingham,721321839,Matt Peake,4,4,0
608140548,David Gillingham,809568302,Mark Johnson,4,1,3
613893140,Matt Warner,835713833,Olly Stewart,4,0,4
617751649,Lee Simpson,646410961,Paul Scorer,4,3,1
617751649,Lee Simpson,748064029,Paul Hughes,4,3,1
617751649,Lee Simpson,752709358,Chris Mason,4,2,2
617751649,Lee Simpson,797962517,Dave Lewis,4,3,1
617751649,Lee Simpson,947143243,Chris Davis,4,1,3
617751649,Lee Simpson,948504778,Jon Fordham,4,4,0
617751649,Lee Simpson,963958265,Rodney Moogan,4,4,0
619390728,Steve Stylianou,754250007,Freddie Blunden,4,2,2
646410961,Paul Scorer,670256222,Connor Anderson,4,1,3
646410961,Paul Scorer,766684900,John Gillard,4,0,4
649240057,Mike Childs,815023707,David Senior,4,1,3
654650203,Alan O'Sullivan,970786910,Kevin Sorrell,4,2,2
662568995,Rob Wykes,748064029,Paul Hughes,4,2,2
662568995,Rob Wykes,754250007,Freddie Blunden,4,1,3
662568995,Rob Wykes,809568302,Mark Johnson,4,2,2
666735933,Mike Collier,748064029,Paul Hughes,4,4,0
666735933,Mike Collier,766684900,John Gillard,4,1,3
669385277,Steve Towler,704007508,Alan Muir,4,2,2
670034050,John Muzio,845758589,Charlie James,4,4,0
670034050,John Muzio,899206834,Jez Downs,4,3,1
670256222,Connor Anderson,764177688,Barry Martin,4,2,2
670256222,Connor Anderson,794630189,Mark Coles,4,4,0
670256222,Connor Anderson,797962517,Dave Lewis,4,2,2
670870044,David Flanagan,732415457,Barry Hall,4,2,2
677110925,Jake Dunstall,866506631,Mark Smith,4,2,2
680442672,Scott Lawson,963958265,Rodney Moogan,4,2,2
688252012,Sean Cooper,733453947,Phil Canham,4,1,3
688252012,Sean Cooper,788605510,Mark Rose,4,0,4
688252012,Sean Cooper,867613624,Ian Dunhill,4,3,1
688778183,Dean Paice,880982797,Ray Hunter,4,3,1
688778183,Dean Paice,943667183,John Stone,4,3,1
717256135,Trevor Pickard,719124015,Tony Power,4,4,0
719124015,Tony Power,736672590,Dean Perry,4,2,2
719124015,Tony Power,873916947,Geoff Akehurst,4,3,1
732415457,Barry Hall,867613624,Ian Dunhill,4,2,2
733453947,Phil Canham,835713833,Olly Stewart,4,0,4
736672590,Dean Perry,954080507,Sam Corsby,4,2,2
745152759,Kevin Jewell,978156264,Bob Paine,4,2,2
748064029,Paul Hughes,754250007,Freddie Blunden,4,1,3
752709358,Chris Mason,764177688,Barry Martin,4,2,2
764177688,Barry Martin,957784480,Harry Banks,4,3,1
766684900,John Gillard,957784480,Harry Banks,4,3,1
794630189,Mark Coles,957784480,Harry Banks,4,4,0
802242736,Steve Hughes,948504778,Jon Fordham,4,1,3
809647573,John Taylor,954080507,Sam Corsby,4,4,0
809984729,Neil Scutt,899206834,Jez Downs,4,2,2
815023707,David Senior,978156264,Bob Paine,4,2,2
833156731,Jez Saunders,866506631,Mark Smith,4,2,2
833156731,Jez Saunders,963206772,Dean Moore,4,0,4
845537273,Dave Gridley,954080507,Sam Corsby,4,4,0
866506631,Mark Smith,936624299,Peter Gallant,4,4,0
880982797,Ray Hunter,970786910,Kevin Sorrell,4,2,2
899206834,Jez Downs,949603489,Pete Bennett,4,1,3
922772801,Nick Buonanno,929636592,Danny Wilson,4,4,0
929636592,Danny Wilson,936624299,Peter Gallant,4,2,2
936624299,Peter Gallant,953512654,Les Berry,4,2,2
943667183,John Stone,966905561,Tony Dade,4,3,1
966905561,Tony Dade,971308746,Clive Harman,4,0,4
3,Neal Gozzett,619390728,Steve Stylianou,3,1,2
3,Neal Gozzett,754250007,Freddie Blunden,3,0,3
3,Neal Gozzett,802242736,Steve Hughes,3,3,0
5,Paul Osiecki,444639447,Andy Wong,3,3,0
6,Dan Stirling,136,Dave Bonwick,3,2,1
6,Dan Stirling,222,John Newnhan,3,2,1
6,Dan Stirling,809568302,Mark Johnson,3,3,0
6,Dan Stirling,963958265,Rodney Moogan,3,2,1
14,Michael West,136,Dave Bonwick,3,3,0
16,Mick Beck,202090738,Alan Head,3,3,0
16,Mick Beck,231445676,Tony Paice,3,3,0
16,Mick Beck,608140548,David Gillingham,3,1,2
16,Mick Beck,800114325,Roger Whiteley,3,2,1
16,Mick Beck,809568302,Mark Johnson,3,0,3
17,Tony Funnell,202090738,Alan Head,3,2,1
38,Rob Bowden,307,Alister Morrison,3,0,3
38,Rob Bowden,411473516,Ray Canham,3,1,2
38,Rob Bowden,845758589,Charlie James,3,3,0
38,Rob Bowden,954639632,Derek Budde,3,0,3
61,Paul Gander,503528426,Larry Maloney,3,2,1
63,Colin Penson,600385553,Darren Welfare,3,0,3
63,Colin Penson,947620111,Neil Cutler,3,2,1
65,Paul Hudson,231445676,Tony Paice,3,0,3
65,Paul Hudson,503528426,Larry Maloney,3,3,0
65,Paul Hudson,831214643,Tony Shipley,3,0,3
70,Michael Turner-Lee,278731588,Lester Grice,3,1,2
70,Michael Turner-Lee,503528426,Larry Maloney,3,2,1
70,Michael Turner-Lee,957784480,Harry Banks,3,1,2
76,David Rea,974385564,Danny Booker,3,1,2
80,Dave Wells,244,Dave Burchett,3,0,3
80,Dave Wells,445,Lachlan Monroe,3,0,3
80,Dave Wells,266477517,Tony Baxter,3,1,2
80,Dave Wells,291198629,Tony Burt,3,2,1
80,Dave Wells,556095121,Tom Wright,3,2,1
80,Dave Wells,966905561,Tony Dade,3,0,3
80,Dave Wells,978156264,Bob Paine,3,3,0
81,Nick Bollingbroke,713064363,John Trory,3,2,1
83,Eric Gumbrell,182,Brian Welfare,3,0,3
88,Steve Collins,836895047,Ian McKay,3,1,2
89,Mike Atkins,231445676,Tony Paice,3,0,3
89,Mike Atkins,503528426,Larry Maloney,3,3,0
92,Dale Thomas,32061370,Toby Prince-Iles,3,2,1
92,Dale Thomas,275738778,John Da Silva,3,0,3
96,Dave Kellett,415524562,Dave King,3,3,0
96,Dave Kellett,612265840,Paul Honeysett,3,2,1
97,Shaun Winsor,573567936,Steve Marriott,3,2,1
98,Tony Collins,282,Adam Harrild,3,2,1
98,Tony Collins,394906196,Mick Mabbitt,3,2,1
98,Tony Collins,415524562,Dave King,3,2,1
98,Tony Collins,535728699,Fred Cooper,3,1,2
98,Tony Collins,567624732,Dave Brampton,3,0,3
98,Tony Collins,858283721,Dave Dunstall,3,0,3
98,Tony Collins,963206772,Dean Moore,3,0,3
102,Reece Childs,285,Pete Davie,3,0,3
102,Reece Childs,844676925,Kieran Williams,3,1,2
108,John Wooller,395,Herby Burchell,3,1,2
108,John Wooller,266591683,Chris Roche,3,0,3
115,Jim Collins,114184042,Ian Smith,3,2,1
121,Mike Barnett,295,Graham Still,3,3,0
121,Mike Barnett,174147986,Lee Cliff,3,0,3
121,Mike Barnett,444350794,Richard Freeman,3,2,1
121,Mike Barnett,455401154,Kai Ellis,3,1,2
121,Mike Barnett,878576746,Jon Hall,3,3,0
121,Mike Barnett,974385564,Danny Booker,3,2,1
124,Dave Tristram,300,Graham Smart,3,3,0
124,Dave Tristram,337,Adam Williams,3,2,1
124,Dave Tristram,733453947,Phil Canham,3,1,2
127,Dave Turner,613893140,Matt Warner,3,0,3
133,Darren Bradley,223,Ollie Stalley,3,0,3
133,Darren Bradley,619390728,Steve Stylianou,3,0,3
136,Dave Bonwick,345558874,Zack Richardson,3,0,3
136,Dave Bonwick,444639447,Andy Wong,3,1,2
136,Dave Bonwick,608140548,David Gillingham,3,2,1
136,Dave Bonwick,809568302,Mark Johnson,3,1,2
137,Ricky Beecham,222,John Newnhan,3,2,1
149,Tony Nealgrove,845758589,Charlie James,3,1,2
149,Tony Nealgrove,963206772,Dean Moore,3,2,1
164,Neil Bushell,845758589,Charlie James,3,0,3
171,Darren Bell,802242736,Steve Hughes,3,2,1
171,Darren Bell,837429850,Paul Beecham,3,3,0
173,Dave Alderton,117247901,Dave Verey,3,1,2
173,Dave Alderton,327948141,Ross Etheridge,3,1,2
173,Dave Alderton,574248035,Tony Mulhern,3,0,3
173,Dave Alderton,974385564,Danny Booker,3,1,2
174,Brian Grant,171346729,Des Heasman,3,1,2
174,Brian Grant,225850882,John McLellan,3,1,2
174,Brian Grant,455401154,Kai Ellis,3,2,1
174,Brian Grant,670256222,Connor Anderson,3,0,3
175,Dudley Rignall,300,Graham Smart,3,2,1
175,Dudley Rignall,641692362,Bob Taylor,3,0,3
177,John Regan,303,Graham Williard,3,0,3
179,Mick Jones,677110925,Jake Dunstall,3,3,0
179,Mick Jones,968651401,Ryan Grover,3,2,1
180,Pat Sweeney,117247901,Dave Verey,3,0,3
180,Pat Sweeney,420230435,Jack Fielder,3,0,3
181,Dave Roughley,202,Bob Firth,3,3,0
181,Dave Roughley,677110925,Jake Dunstall,3,3,0
181,Dave Roughley,732415457,Barry Hall,3,1,2
182,Brian Welfare,35191252,Nigel Hayward,3,2,1
182,Brian Welfare,670034050,John Muzio,3,0,3
182,Brian Welfare,899206834,Jez Downs,3,2,1
183,Simon Alexander,35191252,Nigel Hayward,3,2,1
183,Simon Alexander,275738778,John Da Silva,3,1,2
183,Simon Alexander,351143642,Michael Palmer,3,0,3
183,Simon Alexander,899206834,Jez Downs,3,1,2
183,Simon Alexander,971308746,Clive Harman,3,0,3
188,Phil Turner,417786644,Eddie Collins,3,3,0
193,Gary Goodman,754250007,Freddie Blunden,3,2,1
198,Chris Playford,231445676,Tony Paice,3,2,1
199,Mark Holloway,732415457,Barry Hall,3,2,1
202,Bob Firth,899206834,Jez Downs,3,1,2
222,John Newnhan,617751649,Lee Simpson,3,0,3
223,Ollie Stalley,802242736,Steve Hughes,3,2,1
235,Derek Conley,202090738,Alan Head,3,1,2
235,Derek Conley,661923191,Steve Gardner,3,1,2
235,Derek Conley,831214643,Tony Shipley,3,1,2
236,Lee Garland,266591683,Chris Roche,3,0,3
236,Lee Garland,800114325,Roger Whiteley,3,0,3
236,Lee Garland,947620111,Neil Cutler,3,2,1
239,Mick Lucas,76011459,Kane Harman,3,1,2
239,Mick Lucas,204951513,Mike Holding,3,0,3
239,Mick Lucas,649240057,Mike Childs,3,1,2
239,Mick Lucas,820231590,Alan Rook,3,1,2
247,Mick Justice,430890681,Malcolm Cooper,3,1,2
247,Mick Justice,535728699,Fred Cooper,3,1,2
247,Mick Justice,820231590,Alan Rook,3,3,0
247,Mick Justice,910809545,Blake Harman,3,2,1
247,Mick Justice,966905561,Tony Dade,3,2,1
272,Carlo Lupi,298,T. Harding,3,2,1
272,Carlo Lupi,608140548,David Gillingham,3,0,3
275,Brian Balchin,307,Alister Morrison,3,1,2
278,Dave Fairbairn,16253983,Tony Simmonds,3,0,3
278,Dave Fairbairn,411473516,Ray Canham,3,1,2
278,Dave Fairbairn,677110925,Jake Dunstall,3,1,2
278,Dave Fairbairn,713064363,John Trory,3,3,0
282,Adam Harrild,495939788,Tyrone Davis,3,3,0
282,Adam Harrild,523395206,Jamie Lashmar,3,0,3
284,Ray Bradley,649240057,Mike Childs,3,0,3
288,Pete Elliott,392533233,Jack Wright,3,2,1
294,Bob Tullett,805165161,Steve Owen,3,3,0
297,S. Grogan,455401154,Kai Ellis,3,0,3
301,Terry Grant,213264678,Martin Hall,3,1,2
303,Graham Williard,641692362,Bob Taylor,3,2,1
307,Alister Morrison,225247539,Barry Knight,3,3,0
307,Alister Morrison,510918620,Robert Bowden,3,3,0
307,Alister Morrison,873916947,Geoff Akehurst,3,3,0
316,Paul Redgate,556095121,Tom Wright,3,0,3
319,John Lojo,171346729,Des Heasman,3,1,2
319,John Lojo,174147986,Lee Cliff,3,1,2
319,John Lojo,845537273,Dave Gridley,3,3,0
321,Mick Ingram,455401154,Kai Ellis,3,1,2
327,Harold Franks,649240057,Mike Childs,3,1,2
327,Harold Franks,929636592,Danny Wilson,3,0,3
356,Scott Harris,28382047,Steve Harrington,3,1,2
365,Dan Buckwell,90176364,David Page,3,2,1
365,Dan Buckwell,619390728,Steve Stylianou,3,2,1
365,Dan Buckwell,809568302,Mark Johnson,3,2,1
365,Dan Buckwell,957784480,Harry Banks,3,3,0
367,Chris Dolding,266591683,Chris Roche,3,3,0
367,Chris Dolding,279543944,Peter Maurice,3,2,1
372,Jim Race,440,Gordon Carter,3,2,1
374,Lloyd Saunders,884374645,Wayne Iddon,3,2,1
377,Gary Bradshaw,466,Ben Fielder,3,0,3
377,Gary Bradshaw,294944526,Rob Teanby,3,0,3
378,Simon Howe,229719541,Scott Manning,3,1,2
384,Bryan Beck,815023707,David Senior,3,3,0
384,Bryan Beck,820231590,Alan Rook,3,3,0
386,Sam Hains,498330760,Mo Collins,3,2,1
394,Alan Burchell,719124015,Tony Power,3,2,1
394,Alan Burchell,831214643,Tony Shipley,3,2,1
394,Alan Burchell,836895047,Ian McKay,3,1,2
395,Herby Burchell,231445676,Tony Paice,3,0,3
395,Herby Burchell,529382351,Greg Foat,3,2,1
395,Herby Burchell,661923191,Steve Gardner,3,3,0
403,Joe Marcuson,392533233,Jack Wright,3,1,2
431,Darren Jordan,802242736,Steve Hughes,3,3,0
442,Harvey Tuck,294944526,Rob Teanby,3,2,1
442,Harvey Tuck,567624732,Dave Brampton,3,0,3
445,Lachlan Monroe,649240057,Mike Childs,3,3,0
456,Daniel Marcantonio,319057545,Brendan Lambe,3,0,3
466,Ben Fielder,484159049,Tommy Wright,3,0,3
486,"Jim, Jr. Stevens",805165161,Steve Owen,3,1,2
487,"Jim, Sr. Stevens",171346729,Des Heasman,3,0,3
487,"Jim, Sr. Stevens",411473516,Ray Canham,3,2,1
488,Roger Harrold,878576746,Jon Hall,3,1,2
496,Lucas Flux,820231590,Alan Rook,3,2,1
515,Simon Mackenzie,266477517,Tony Baxter,3,2,1
3508579,John Murray,174147986,Lee Cliff,3,1,2
3508579,John Murray,411473516,Ray Canham,3,0,3
3508579,John Murray,598846718,Ben Sorrell,3,3,0
3508579,John Murray,866506631,Mark Smith,3,0,3
3508579,John Murray,971308746,Clive Harman,3,1,2
5820499,Paul Bartlett,26970170,Kai Michael,3,2,1
5820499,Paul Bartlett,90176364,David Page,3,1,2
5820499,Paul Bartlett,307140835,Tony Strange,3,0,3
5820499,Paul Bartlett,384960657,Dave Lewney,3,1,2
5820499,Paul Bartlett,515186402,Ben Evans,3,0,3
5820499,Paul Bartlett,670256222,Connor Anderson,3,0,3
5820499,Paul Bartlett,809568302,Mark Johnson,3,0,3
11133032,Simon Dent,34787509,Dave McCarthy,3,3,0
11133032,Simon Dent,60575249,Ash Thurmer,3,3,0
11133032,Simon Dent,341869673,Nigel Stilwell,3,1,2
11133032,Simon Dent,345558874,Zack Richardson,3,1,2
11133032,Simon Dent,506581042,Glen Dartnell,3,3,0
11133032,Simon Dent,732321233,Nathan Brooks,3,3,0
16253983,Tony Simmonds,41098823,Mikey Booker,3,3,0
16253983,Tony Simmonds,225247539,Barry Knight,3,3,0
16253983,Tony Simmonds,669385277,Steve Towler,3,3,0
16253983,Tony Simmonds,680442672,Scott Lawson,3,2,1
16253983,Tony Simmonds,773216781,Sean Payne,3,2,1
16253983,Tony Simmonds,835713833,Olly Stewart,3,2,1
16253983,Tony Simmonds,878576746,Jon Hall,3,3,0
26970170,Kai Michael,90176364,David Page,3,2,1
26970170,Kai Michael,307140835,Tony Strange,3,1,2
26970170,Kai Michael,646410961,Paul Scorer,3,0,3
26970170,Kai Michael,748064029,Paul Hughes,3,1,2
26970170,Kai Michael,957784480,Harry Banks,3,1,2
27255501,Tom Lane,171346729,Des Heasman,3,0,3
27255501,Tom Lane,291198629,Tony Burt,3,2,1
27255501,Tom Lane,293577764,Dave Crosskey,3,2,1
27255501,Tom Lane,360777082,Mark Bishop,3,0,3
27255501,Tom Lane,430890681,Malcolm Cooper,3,0,3
27255501,Tom Lane,567316488,Lee Millyard,3,1,2
27255501,Tom Lane,579164381,Danny Cattell,3,1,2
27255501,Tom Lane,704007508,Alan Muir,3,0,3
27255501,Tom Lane,724342701,Nigel Lilley,3,0,3
28382047,Steve Harrington,410854609,Dave Lowe,3,0,3
28382047,Steve Harrington,613893140,Matt Warner,3,0,3
28382047,Steve Harrington,688252012,Sean Cooper,3,1,2
28382047,Steve Harrington,836895047,Ian McKay,3,2,1
32061370,Toby Prince-Iles,171346729,Des Heasman,3,0,3
32061370,Toby Prince-Iles,271464632,Paul Phillips,3,1,2
32061370,Toby Prince-Iles,430890681,Malcolm Cooper,3,2,1
32061370,Toby Prince-Iles,495939788,Tyrone Davis,3,3,0
32061370,Toby Prince-Iles,537640521,Ian Stoner,3,2,1
32061370,Toby Prince-Iles,674307680,Neil McCafferty,3,2,1
32061370,Toby Prince-Iles,688778183,Dean Paice,3,1,2
32061370,Toby Prince-Iles,788605510,Mark Rose,3,0,3
32061370,Toby Prince-Iles,809984729,Neil Scutt,3,2,1
32061370,Toby Prince-Iles,815023707,David Senior,3,2,1
32061370,Toby Prince-Iles,970786910,Kevin Sorrell,3,0,3
34787509,Dave McCarthy,96103077,Paul Norris,3,0,3
34787509,Dave McCarthy,326342962,Geoff Randall,3,0,3
34787509,Dave McCarthy,384960657,Dave Lewney,3,1,2
34787509,Dave McCarthy,662568995,Rob Wykes,3,3,0
34787509,Dave McCarthy,688252012,Sean Cooper,3,3,0
35191252,Nigel Hayward,688778183,Dean Paice,3,0,3
39289507,Mick Laughlin,229719541,Scott Manning,3,0,3
39289507,Mick Laughlin,319057545,Brendan Lambe,3,2,1
39289507,Mick Laughlin,535728699,Fred Cooper,3,1,2
39289507,Mick Laughlin,649240057,Mike Childs,3,3,0
39289507,Mick Laughlin,815023707,David Senior,3,3,0
39289507,Mick Laughlin,899206834,Jez Downs,3,2,1
41098823,Mikey Booker,114184042,Ian Smith,3,3,0
41098823,Mikey Booker,163959771,Alex El-Deweiny,3,2,1
41098823,Mikey Booker,463709832,Danny Wong,3,2,1
41098823,Mikey Booker,484159049,Tommy Wright,3,1,2
41098823,Mikey Booker,490170224,Jamie Matthews,3,3,0
41098823,Mikey Booker,822983250,Alasdair Pratt,3,0,3
41098823,Mikey Booker,837429850,Paul Beecham,3,2,1
41461520,Luke Pooley,45305697,John Barratt,3,1,2
41461520,Luke Pooley,231445676,Tony Paice,3,0,3
41461520,Luke Pooley,417786644,Eddie Collins,3,1,2
41461520,Luke Pooley,495939788,Tyrone Davis,3,3,0
41461520,Luke Pooley,573567936,Steve Marriott,3,0,3
41461520,Luke Pooley,676753614,Don James,3,0,3
41461520,Luke Pooley,745152759,Kevin Jewell,3,1,2
45305697,John Barratt,612265840,Paul Honeysett,3,2,1
56252722,Dave Pither,246154671,Alan Gunn,3,2,1
56252722,Dave Pither,291816585,Jim Somers,3,2,1
56252722,Dave Pither,612265840,Paul Honeysett,3,0,3
56252722,Dave Pither,746406369,Loz O'Keefe,3,0,3
56252722,Dave Pither,867613624,Ian Dunhill,3,1,2
56252722,Dave Pither,978156264,Bob Paine,3,3,0
59858690,James Constable,112887737,Pip Akehurst,3,2,1
59858690,James Constable,341869673,Nigel Stilwell,3,1,2
59858690,James Constable,444639447,Andy Wong,3,2,1
59858690,James Constable,662568995,Rob Wykes,3,1,2
60575249,Ash Thurmer,515186402,Ben Evans,3,1,2
60575249,Ash Thurmer,617751649,Lee Simpson,3,0,3
60575249,Ash Thurmer,646410961,Paul Scorer,3,0,3
60575249,Ash Thurmer,666735933,Mike Collier,3,1,2
60575249,Ash Thurmer,766684900,John Gillard,3,0,3
60575249,Ash Thurmer,794630189,Mark Coles,3,0,3
60575249,Ash Thurmer,809568302,Mark Johnson,3,1,2
69745818,Ian Bowles,70159035,Peter Rea,3,0,3
69745818,Ian Bowles,293577764,Dave Crosskey,3,0,3
69745818,Ian Bowles,386517733,Ady Halley,3,2,1
69745818,Ian Bowles,535728699,Fred Cooper,3,0,3
69745818,Ian Bowles,573567936,Steve Marriott,3,2,1
70159035,Peter Rea,216787426,Jack Perrin,3,3,0
70159035,Peter Rea,688778183,Dean Paice,3,3,0
70159035,Peter Rea,852327692,Andy Fletcher,3,2,1
70159035,Peter Rea,858283721,Dave Dunstall,3,1,2
70159035,Peter Rea,936624299,Peter Gallant,3,3,0
76011459,Kane Harman,287057630,Darren Hearn,3,3,0
76011459,Kane Harman,360777082,Mark Bishop,3,2,1
76011459,Kane Harman,394906196,Mick Mabbitt,3,3,0
76011459,Kane Harman,567624732,Dave Brampton,3,2,1
76011459,Kane Harman,612265840,Paul Honeysett,3,2,1
76011459,Kane Harman,649240057,Mike Childs,3,2,1
76011459,Kane Harman,669385277,Steve Towler,3,3,0
83590771,Nick Brayne,719124015,Tony Power,3,3,0
83590771,Nick Brayne,836895047,Ian McKay,3,1,2
96103077,Paul Norris,133207947,Jake Richardson,3,3,0
96103077,Paul Norris,307140835,Tony Strange,3,3,0
96103077,Paul Norris,428102632,Anthony Flynn,3,3,0
96103077,Paul Norris,463709832,Danny Wong,3,3,0
96103077,Paul Norris,480772114,Kevin Ward,3,3,0
96103077,Paul Norris,797962517,Dave Lewis,3,3,0
101751030,Simon Uddin,394906196,Mick Mabbitt,3,1,2
101751030,Simon Uddin,498330760,Mo Collins,3,2,1
101751030,Simon Uddin,501266206,David Fox,3,1,2
101751030,Simon Uddin,676753614,Don James,3,2,1
110039677,Mick Miller,326342962,Geoff Randall,3,1,2
110039677,Mick Miller,503528426,Larry Maloney,3,2,1
110039677,Mick Miller,820231590,Alan Rook,3,2,1
112887737,Pip Akehurst,617751649,Lee Simpson,3,0,3
112887737,Pip Akehurst,654650203,Alan O'Sullivan,3,3,0
112887737,Pip Akehurst,704007508,Alan Muir,3,3,0
112887737,Pip Akehurst,734416600,DON PENALVER,3,3,0
114184042,Ian Smith,231445676,Tony Paice,3,0,3
114184042,Ian Smith,279543944,Peter Maurice,3,2,1
114184042,Ian Smith,306438070,Martin Stocker,3,0,3
114184042,Ian Smith,567316488,Lee Millyard,3,2,1
114184042,Ian Smith,704007508,Alan Muir,3,2,1
114319292,Oliver Gorrod,732415457,Barry Hall,3,0,3
114319292,Oliver Gorrod,899206834,Jez Downs,3,1,2
118679261,Mick Lott,974385564,Danny Booker,3,1,2
120138229,Adam Butler,726498878,Grigory Yashkov,3,2,1
120138229,Adam Butler,835713833,Olly Stewart,3,1,2
120138229,Adam Butler,848997254,Tom Parker,3,2,1
124523642,Tom Hayes,412256116,Andy Sutton,3,1,2
124523642,Tom Hayes,490170224,Jamie Matthews,3,2,1
124523642,Tom Hayes,704007508,Alan Muir,3,2,1
124523642,Tom Hayes,721321839,Matt Peake,3,1,2
124523642,Tom Hayes,788605510,Mark Rose,3,1,2
124523642,Tom Hayes,800114325,Roger Whiteley,3,1,2
124523642,Tom Hayes,848997254,Tom Parker,3,1,2
124523642,Tom Hayes,974385564,Danny Booker,3,0,3
133207947,Jake Richardson,323907964,Russ Hughes,3,0,3
133207947,Jake Richardson,356397577,David Morgan,3,0,3
133207947,Jake Richardson,444639447,Andy Wong,3,3,0
133207947,Jake Richardson,617751649,Lee Simpson,3,1,2
133207947,Jake Richardson,666735933,Mike Collier,3,1,2
141540226,Pete Hazell,279543944,Peter Maurice,3,3,0
144293731,Simon Parry,278731588,Lester Grice,3,1,2
144293731,Simon Parry,646410961,Paul Scorer,3,1,2
144293731,Simon Parry,670256222,Connor Anderson,3,1,2
144776055,Brian Wilkes,480154054,Jim Dunstall,3,2,1
144776055,Brian Wilkes,506320151,Frank Taylor,3,2,1
144776055,Brian Wilkes,535728699,Fred Cooper,3,1,2
144776055,Brian Wilkes,598117191,Jerome Fowler,3,1,2
144776055,Brian Wilkes,598846718,Ben Sorrell,3,3,0
144776055,Brian Wilkes,623613383,Chris Marsh,3,1,2
144776055,Brian Wilkes,713064363,John Trory,3,3,0
144776055,Brian Wilkes,835713833,Olly Stewart,3,0,3
144776055,Brian Wilkes,866506631,Mark Smith,3,0,3
144776055,Brian Wilkes,867613624,Ian Dunhill,3,1,2
144776055,Brian Wilkes,880982797,Ray Hunter,3,2,1
146404254,Randall Griffiths,287057630,Darren Hearn,3,3,0
146404254,Randall Griffiths,360777082,Mark Bishop,3,1,2
146404254,Randall Griffiths,971308746,Clive Harman,3,3,0
147556923,Hong Ming Lee,717256135,Trevor Pickard,3,3,0
160950731,Locky McCurdy,266477517,Tony Baxter,3,2,1
160950731,Locky McCurdy,506320151,Frank Taylor,3,2,1
160950731,Locky McCurdy,567316488,Lee Millyard,3,2,1
160950731,Locky McCurdy,757827662,Clive Freestone,3,1,2
160950731,Locky McCurdy,880982797,Ray Hunter,3,2,1
160950731,Locky McCurdy,936624299,Peter Gallant,3,2,1
171346729,Des Heasman,535728699,Fred Cooper,3,3,0
171346729,Des Heasman,717256135,Trevor Pickard,3,0,3
171346729,Des Heasman,835713833,Olly Stewart,3,1,2
171346729,Des Heasman,866506631,Mark Smith,3,1,2
171346729,Des Heasman,963206772,Dean Moore,3,1,2
172646809,Robin Powell,216787426,Jack Perrin,3,2,1
172646809,Robin Powell,820231590,Alan Rook,3,0,3
172646809,Robin Powell,831214643,Tony Shipley,3,0,3
172646809,Robin Powell,845758589,Charlie James,3,0,3
172646809,Robin Powell,971308746,Clive Harman,3,0,3
174147986,Lee Cliff,225850882,John McLellan,3,2,1
174147986,Lee Cliff,279543944,Peter Maurice,3,3,0
174147986,Lee Cliff,493830161,Luke Strevens,3,0,3
174147986,Lee Cliff,535728699,Fred Cooper,3,3,0
174147986,Lee Cliff,688252012,Sean Cooper,3,2,1
174147986,Lee Cliff,733453947,Phil Canham,3,2,1
174147986,Lee Cliff,773216781,Sean Payne,3,0,3
174147986,Lee Cliff,835713833,Olly Stewart,3,1,2
174147986,Lee Cliff,867613624,Ian Dunhill,3,1,2
174147986,Lee Cliff,963206772,Dean Moore,3,3,0
174147986,Lee Cliff,974385564,Danny Booker,3,1,2
192463126,Gerry Lindsey,278731588,Lester Grice,3,0,3
192463126,Gerry Lindsey,809568302,Mark Johnson,3,0,3
202090738,Alan Head,661923191,Steve Gardner,3,2,1
202090738,Alan Head,719124015,Tony Power,3,1,2
202090738,Alan Head,733453947,Phil Canham,3,1,2
202090738,Alan Head,836895047,Ian McKay,3,1,2
207592931,(shorty) Gediminas Aleksandravicius,360777082,Mark Bishop,3,1,2
216787426,Jack Perrin,351143642,Michael Palmer,3,2,1
216787426,Jack Perrin,449331249,Dan Tanner,3,3,0
216787426,Jack Perrin,613893140,Matt Warner,3,2,1
223983583,Carl Wentworth,291816585,Jim Somers,3,1,2
223983583,Carl Wentworth,301960429,Brian Collins,3,0,3
223983583,Carl Wentworth,537640521,Ian Stoner,3,2,1
223983583,Carl Wentworth,688778183,Dean Paice,3,0,3
223983583,Carl Wentworth,745152759,Kevin Jewell,3,2,1
223983583,Carl Wentworth,831214643,Tony Shipley,3,0,3
223983583,Carl Wentworth,978156264,Bob Paine,3,3,0
225247539,Barry Knight,301960429,Brian Collins,3,0,3
225247539,Barry Knight,836895047,Ian McKay,3,1,2
225850882,John McLellan,455401154,Kai Ellis,3,2,1
225850882,John McLellan,506320151,Frank Taylor,3,1,2
225850882,John McLellan,641692362,Bob Taylor,3,1,2
225850882,John McLellan,733453947,Phil Canham,3,1,2
225850882,John McLellan,866506631,Mark Smith,3,3,0
225850882,John McLellan,873916947,Geoff Akehurst,3,2,1
227209116,Peter Rawlinson,573567936,Steve Marriott,3,1,2
229719541,Scott Manning,349269645,Barry Thornton,3,3,0
229719541,Scott Manning,382970973,Paul Shaw,3,2,1
229719541,Scott Manning,392533233,Jack Wright,3,3,0
229719541,Scott Manning,410854609,Dave Lowe,3,2,1
229719541,Scott Manning,506581042,Glen Dartnell,3,2,1
229719541,Scott Manning,670870044,David Flanagan,3,2,1
229719541,Scott Manning,844676925,Kieran Williams,3,2,1
231445676,Tony Paice,363402934,Rod Phillippe,3,3,0
231445676,Tony Paice,495939788,Tyrone Davis,3,3,0
231445676,Tony Paice,503528426,Larry Maloney,3,2,1
231445676,Tony Paice,836895047,Ian McKay,3,0,3
231975313,Danny English,809568302,Mark Johnson,3,1,2
231975313,Danny English,927588200,Tokki Yamaguchi,3,1,2
254776886,Leighton Cole,363402934,Rod Phillippe,3,1,2
258340682,John Derret,326342962,Geoff Randall,3,0,3
258549102,Tony Lee,279543944,Peter Maurice,3,2,1
266477517,Tony Baxter,430890681,Malcolm Cooper,3,1,2
266591683,Chris Roche,279543944,Peter Maurice,3,2,1
271464632,Paul Phillips,567316488,Lee Millyard,3,1,2
271464632,Paul Phillips,612265840,Paul Honeysett,3,1,2
271464632,Paul Phillips,688778183,Dean Paice,3,1,2
271464632,Paul Phillips,963206772,Dean Moore,3,2,1
271464632,Paul Phillips,971308746,Clive Harman,3,1,2
275738778,John Da Silva,382970973,Paul Shaw,3,1,2
275738778,John Da Silva,394906196,Mick Mabbitt,3,3,0
275738778,John Da Silva,480154054,Jim Dunstall,3,2,1
275738778,John Da Silva,573567936,Steve Marriott,3,3,0
275738778,John Da Silva,733453947,Phil Canham,3,1,2
275738778,John Da Silva,858283721,Dave Dunstall,3,1,2
275738778,John Da Silva,866506631,Mark Smith,3,2,1
275738778,John Da Silva,951468676,Steve Burchett,3,1,2
275738778,John Da Silva,974385564,Danny Booker,3,1,2
278731588,Lester Grice,293122482,Stuart Maplesden,3,2,1
278731588,Lester Grice,345558874,Zack Richardson,3,0,3
278731588,Lester Grice,384960657,Dave Lewney,3,2,1
278731588,Lester Grice,444639447,Andy Wong,3,3,0
278731588,Lester Grice,515186402,Ben Evans,3,2,1
278731588,Lester Grice,683709119,Ronnie Beard,3,3,0
278731588,Lester Grice,717256135,Trevor Pickard,3,2,1
278731588,Lester Grice,800114325,Roger Whiteley,3,3,0
278731588,Lester Grice,865803068,Dave Jones,3,0,3
278731588,Lester Grice,947143243,Chris Davis,3,1,2
279543944,Peter Maurice,444350794,Richard Freeman,3,2,1
279543944,Peter Maurice,649240057,Mike Childs,3,2,1
279543944,Peter Maurice,688778183,Dean Paice,3,1,2
279543944,Peter Maurice,922772801,Nick Buonanno,3,2,1
279543944,Peter Maurice,947620111,Neil Cutler,3,1,2
287057630,Darren Hearn,319057545,Brendan Lambe,3,1,2
287057630,Darren Hearn,394906196,Mick Mabbitt,3,3,0
287057630,Darren Hearn,430890681,Malcolm Cooper,3,1,2
287057630,Darren Hearn,444350794,Richard Freeman,3,2,1
287057630,Darren Hearn,833156731,Jez Saunders,3,0,3
287057630,Darren Hearn,899206834,Jez Downs,3,0,3
289915561,Craig Dummer,957784480,Harry Banks,3,2,1
291198629,Tony Burt,409212679,Mark Chapman,3,1,2
291198629,Tony Burt,567624732,Dave Brampton,3,0,3
291198629,Tony Burt,815023707,David Senior,3,1,2
291198629,Tony Burt,867613624,Ian Dunhill,3,0,3
291816585,Jim Somers,386517733,Ady Halley,3,0,3
291816585,Jim Somers,535728699,Fred Cooper,3,0,3
291816585,Jim Somers,567624732,Dave Brampton,3,0,3
291816585,Jim Somers,573567936,Steve Marriott,3,1,2
291816585,Jim Somers,612265840,Paul Honeysett,3,0,3
291816585,Jim Somers,951468676,Steve Burchett,3,0,3
293577764,Dave Crosskey,349269645,Barry Thornton,3,0,3
293577764,Dave Crosskey,386517733,Ady Halley,3,1,2
293577764,Dave Crosskey,394906196,Mick Mabbitt,3,1,2
293577764,Dave Crosskey,430890681,Malcolm Cooper,3,2,1
293577764,Dave Crosskey,567624732,Dave Brampton,3,2,1
293577764,Dave Crosskey,573567936,Steve Marriott,3,1,2
293577764,Dave Crosskey,704007508,Alan Muir,3,1,2
293577764,Dave Crosskey,745152759,Kevin Jewell,3,1,2
293577764,Dave Crosskey,858283721,Dave Dunstall,3,0,3
293577764,Dave Crosskey,936624299,Peter Gallant,3,1,2
293577764,Dave Crosskey,966905561,Tony Dade,3,2,1
294944526,Rob Teanby,351143642,Michael Palmer,3,2,1
294944526,Rob Teanby,804381932,Ryan Harman,3,1,2
294944526,Rob Teanby,966905561,Tony Dade,3,3,0
301960429,Brian Collins,951468676,Steve Burchett,3,2,1
306438070,Martin Stocker,670034050,John Muzio,3,1,2
307140835,Tony Strange,428102632,Anthony Flynn,3,2,1
307140835,Tony Strange,523395206,Jamie Lashmar,3,1,2
307140835,Tony Strange,608140548,David Gillingham,3,3,0
307140835,Tony Strange,617751649,Lee Simpson,3,0,3
307140835,Tony Strange,670256222,Connor Anderson,3,3,0
307140835,Tony Strange,794630189,Mark Coles,3,2,1
307140835,Tony Strange,957784480,Harry Banks,3,1,2
319057545,Brendan Lambe,409212679,Mark Chapman,3,1,2
319057545,Brendan Lambe,535728699,Fred Cooper,3,3,0
319057545,Brendan Lambe,567316488,Lee Millyard,3,1,2
319057545,Brendan Lambe,884374645,Wayne Iddon,3,3,0
323907964,Russ Hughes,523395206,Jamie Lashmar,3,1,2
323907964,Russ Hughes,629014363,Lee Shepherd,3,2,1
323907964,Russ Hughes,666735933,Mike Collier,3,3,0
323907964,Russ Hughes,670256222,Connor Anderson,3,2,1
323907964,Russ Hughes,732321233,Nathan Brooks,3,3,0
323907964,Russ Hughes,794630189,Mark Coles,3,1,2
323907964,Russ Hughes,876526526,Ash Bull,3,2,1
323907964,Russ Hughes,957784480,Harry Banks,3,3,0
326342962,Geoff Randall,670034050,John Muzio,3,2,1
326342962,Geoff Randall,721321839,Matt Peake,3,3,0
326342962,Geoff Randall,800114325,Roger Whiteley,3,2,1
326342962,Geoff Randall,802242736,Steve Hughes,3,2,1
327948141,Ross Etheridge,669385277,Steve Towler,3,1,2
327948141,Ross Etheridge,899206834,Jez Downs,3,2,1
341869673,Nigel Stilwell,506581042,Glen Dartnell,3,1,2
341869673,Nigel Stilwell,654650203,Alan O'Sullivan,3,2,1
341869673,Nigel Stilwell,670256222,Connor Anderson,3,0,3
341869673,Nigel Stilwell,680442672,Scott Lawson,3,2,1
345558874,Zack Richardson,617751649,Lee Simpson,3,2,1
345558874,Zack Richardson,619390728,Steve Stylianou,3,2,1
349269645,Barry Thornton,417786644,Eddie Collins,3,2,1
349269645,Barry Thornton,490170224,Jamie Matthews,3,2,1
351143642,Michael Palmer,364867274,Dave Lucking,3,1,2
351143642,Michael Palmer,833156731,Jez Saunders,3,3,0
351143642,Michael Palmer,884365412,Dave Haslam,3,0,3
351143642,Michael Palmer,889234854,Paul Smith,3,2,1
351143642,Michael Palmer,968651401,Ryan Grover,3,2,1
356397577,David Morgan,390364577,Mark Bright,3,2,1
356397577,David Morgan,426009127,Bav Patel,3,2,1
356397577,David Morgan,948504778,Jon Fordham,3,3,0
360777082,Mark Bishop,394906196,Mick Mabbitt,3,3,0
360777082,Mark Bishop,402257815,Jim Cumming,3,3,0
360777082,Mark Bishop,444350794,Richard Freeman,3,2,1
360777082,Mark Bishop,484159049,Tommy Wright,3,2,1
360777082,Mark Bishop,736672590,Dean Perry,3,2,1
360777082,Mark Bishop,845758589,Charlie James,3,3,0
382970973,Paul Shaw,670034050,John Muzio,3,1,2
382970973,Paul Shaw,889234854,Paul Smith,3,1,2
384960657,Dave Lewney,670256222,Connor Anderson,3,1,2
384960657,Dave Lewney,754250007,Freddie Blunden,3,1,2
384960657,Dave Lewney,764177688,Barry Martin,3,2,1
384960657,Dave Lewney,766684900,John Gillard,3,0,3
386517733,Ady Halley,669385277,Steve Towler,3,0,3
386517733,Ady Halley,845758589,Charlie James,3,2,1
386517733,Ady Halley,858283721,Dave Dunstall,3,1,2
386517733,Ady Halley,943667183,John Stone,3,2,1
390364577,Mark Bright,809568302,Mark Johnson,3,1,2
392533233,Jack Wright,411473516,Ray Canham,3,0,3
392533233,Jack Wright,498330760,Mo Collins,3,2,1
392533233,Jack Wright,670034050,John Muzio,3,0,3
392533233,Jack Wright,713064363,John Trory,3,1,2
392533233,Jack Wright,746406369,Loz O'Keefe,3,1,2
392533233,Jack Wright,915035871,Kevin Graysmark,3,2,1
394906196,Mick Mabbitt,417786644,Eddie Collins,3,0,3
394906196,Mick Mabbitt,613893140,Matt Warner,3,0,3
394906196,Mick Mabbitt,688252012,Sean Cooper,3,1,2
394906196,Mick Mabbitt,844676925,Kieran Williams,3,1,2
394906196,Mick Mabbitt,889234854,Paul Smith,3,2,1
401846353,Frank McHugh,567624732,Dave Brampton,3,0,3
401846353,Frank McHugh,844676925,Kieran Williams,3,1,2
401846353,Frank McHugh,943667183,John Stone,3,1,2
402257815,Jim Cumming,613893140,Matt Warner,3,0,3
402257815,Jim Cumming,669385277,Steve Towler,3,1,2
402257815,Jim Cumming,688252012,Sean Cooper,3,2,1
402257815,Jim Cumming,788605510,Mark Rose,3,0,3
402257815,Jim Cumming,873916947,Geoff Akehurst,3,1,2
402257815,Jim Cumming,936624299,Peter Gallant,3,1,2
409212679,Mark Chapman,411473516,Ray Canham,3,1,2
409212679,Mark Chapman,845758589,Charlie James,3,3,0
409212679,Mark Chapman,867613624,Ian Dunhill,3,2,1
410854609,Dave Lowe,676753614,Don James,3,3,0
411473516,Ray Canham,510918620,Robert Bowden,3,2,1
411473516,Ray Canham,598846718,Ben Sorrell,3,2,1
411473516,Ray Canham,613893140,Matt Warner,3,2,1
411473516,Ray Canham,629014363,Lee Shepherd,3,0,3
411473516,Ray Canham,936624299,Peter Gallant,3,2,1
411473516,Ray Canham,953512654,Les Berry,3,3,0
412256116,Andy Sutton,608140548,David Gillingham,3,0,3
412256116,Andy Sutton,649078882,Richard Barrett,3,1,2
412256116,Andy Sutton,719124015,Tony Power,3,2,1
412256116,Andy Sutton,721321839,Matt Peake,3,2,1
412256116,Andy Sutton,866506631,Mark Smith,3,3,0
417786644,Eddie Collins,498330760,Mo Collins,3,0,3
417786644,Eddie Collins,804381932,Ryan Harman,3,0,3
417786644,Eddie Collins,833156731,Jez Saunders,3,1,2
417786644,Eddie Collins,889234854,Paul Smith,3,0,3
420230435,Jack Fielder,948504778,Jon Fordham,3,2,1
426009127,Bav Patel,797962517,Dave Lewis,3,1,2
426009127,Bav Patel,948504778,Jon Fordham,3,2,1
426009127,Bav Patel,957784480,Harry Banks,3,3,0
426009127,Bav Patel,963958265,Rodney Moogan,3,2,1
428102632,Anthony Flynn,490170224,Jamie Matthews,3,3,0
428102632,Anthony Flynn,529382351,Greg Foat,3,3,0
428102632,Anthony Flynn,773216781,Sean Payne,3,3,0
430890681,Malcolm Cooper,535728699,Fred Cooper,3,1,2
430890681,Malcolm Cooper,820231590,Alan Rook,3,2,1
430890681,Malcolm Cooper,867613624,Ian Dunhill,3,1,2
430890681,Malcolm Cooper,970786910,Kevin Sorrell,3,0,3
436708540,Bob Henley,464085958,Gerwyn Bowen,3,1,2
436708540,Bob Henley,704007508,Alan Muir,3,2,1
436708540,Bob Henley,974385564,Danny Booker,3,1,2
444339215,Steve Richards,845758589,Charlie James,3,2,1
444350794,Richard Freeman,688252012,Sean Cooper,3,1,2
444350794,Richard Freeman,915035871,Kevin Graysmark,3,1,2
444350794,Richard Freeman,974385564,Danny Booker,3,0,3
444639447,Andy Wong,617751649,Lee Simpson,3,1,2
455401154,Kai Ellis,974385564,Danny Booker,3,1,2
463709832,Danny Wong,608140548,David Gillingham,3,0,3
463709832,Danny Wong,800114325,Roger Whiteley,3,1,2
463709832,Danny Wong,836895047,Ian McKay,3,2,1
463709832,Danny Wong,848997254,Tom Parker,3,1,2
464085958,Gerwyn Bowen,899206834,Jez Downs,3,1,2
479705187,Keith McQueen,676753614,Don James,3,0,3
480154054,Jim Dunstall,573567936,Steve Marriott,3,1,2
480154054,Jim Dunstall,889234854,Paul Smith,3,1,2
480772114,Kevin Ward,802242736,Steve Hughes,3,2,1
484159049,Tommy Wright,490170224,Jamie Matthews,3,3,0
484159049,Tommy Wright,537640521,Ian Stoner,3,3,0
484159049,Tommy Wright,820231590,Alan Rook,3,3,0
484159049,Tommy Wright,963206772,Dean Moore,3,3,0
490170224,Jamie Matthews,523395206,Jamie Lashmar,3,0,3
490170224,Jamie Matthews,598552542,John Colgan,3,1,2
490170224,Jamie Matthews,670034050,John Muzio,3,1,2
490170224,Jamie Matthews,676753614,Don James,3,2,1
490170224,Jamie Matthews,809984729,Neil Scutt,3,1,2
490170224,Jamie Matthews,873916947,Geoff Akehurst,3,3,0
493830161,Luke Strevens,724342701,Nigel Lilley,3,2,1
498330760,Mo Collins,535728699,Fred Cooper,3,0,3
498330760,Mo Collins,866506631,Mark Smith,3,0,3
501266206,David Fox,688252012,Sean Cooper,3,1,2
501266206,David Fox,820231590,Alan Rook,3,1,2
501266206,David Fox,845537273,Dave Gridley,3,1,2
501266206,David Fox,867613624,Ian Dunhill,3,0,3
503528426,Larry Maloney,661923191,Steve Gardner,3,0,3
506581042,Glen Dartnell,662568995,Rob Wykes,3,2,1
506581042,Glen Dartnell,766684900,John Gillard,3,1,2
506581042,Glen Dartnell,802242736,Steve Hughes,3,1,2
506581042,Glen Dartnell,809788967,Brett Williams,3,1,2
506581042,Glen Dartnell,922772801,Nick Buonanno,3,3,0
506581042,Glen Dartnell,957784480,Harry Banks,3,1,2
510918620,Robert Bowden,845758589,Charlie James,3,3,0
510918620,Robert Bowden,954639632,Derek Budde,3,0,3
515186402,Ben Evans,646410961,Paul Scorer,3,0,3
515186402,Ben Evans,662568995,Rob Wykes,3,1,2
515186402,Ben Evans,948504778,Jon Fordham,3,2,1
515186402,Ben Evans,957784480,Harry Banks,3,3,0
515186402,Ben Evans,963958265,Rodney Moogan,3,3,0
523395206,Jamie Lashmar,666735933,Mike Collier,3,3,0
523395206,Jamie Lashmar,754250007,Freddie Blunden,3,1,2
523395206,Jamie Lashmar,766684900,John Gillard,3,1,2
529382351,Greg Foat,608140548,David Gillingham,3,0,3
529382351,Greg Foat,719124015,Tony Power,3,0,3
529382351,Greg Foat,724342701,Nigel Lilley,3,2,1
529382351,Greg Foat,800114325,Roger Whiteley,3,0,3
529382351,Greg Foat,858283721,Dave Dunstall,3,1,2
529382351,Greg Foat,880982797,Ray Hunter,3,0,3
535728699,Fred Cooper,674307680,Neil McCafferty,3,2,1
535728699,Fred Cooper,809984729,Neil Scutt,3,1,2
535728699,Fred Cooper,843981340,Mark Glover,3,1,2
535728699,Fred Cooper,899206834,Jez Downs,3,1,2
535728699,Fred Cooper,954639632,Derek Budde,3,0,3
537640521,Ian Stoner,677110925,Jake Dunstall,3,2,1
537640521,Ian Stoner,867613624,Ian Dunhill,3,2,1
537640521,Ian Stoner,873916947,Geoff Akehurst,3,1,2
546362444,Anthony Trory,809984729,Neil Scutt,3,2,1
561171273,Andy Norman,600385553,Darren Welfare,3,3,0
561171273,Andy Norman,646410961,Paul Scorer,3,1,2
567316488,Lee Millyard,732415457,Barry Hall,3,0,3
567316488,Lee Millyard,773216781,Sean Payne,3,0,3
567316488,Lee Millyard,899206834,Jez Downs,3,2,1
567316488,Lee Millyard,929636592,Danny Wilson,3,1,2
567624732,Dave Brampton,573567936,Steve Marriott,3,2,1
567624732,Dave Brampton,613893140,Matt Warner,3,2,1
567624732,Dave Brampton,688778183,Dean Paice,3,0,3
567624732,Dave Brampton,820231590,Alan Rook,3,3,0
567624732,Dave Brampton,867613624,Ian Dunhill,3,2,1
573567936,Steve Marriott,713064363,John Trory,3,2,1
573567936,Steve Marriott,978156264,Bob Paine,3,3,0
574248035,Tony Mulhern,649078882,Richard Barrett,3,0,3
574248035,Tony Mulhern,704007508,Alan Muir,3,2,1
574248035,Tony Mulhern,866506631,Mark Smith,3,2,1
574248035,Tony Mulhern,889234854,Paul Smith,3,1,2
574248035,Tony Mulhern,910809545,Blake Harman,3,1,2
598846718,Ben Sorrell,670034050,John Muzio,3,0,3
598846718,Ben Sorrell,974385564,Danny Booker,3,0,3
600385553,Darren Welfare,957784480,Harry Banks,3,1,2
608140548,David Gillingham,654650203,Alan O'Sullivan,3,3,0
608140548,David Gillingham,717256135,Trevor Pickard,3,3,0
608140548,David Gillingham,788605510,Mark Rose,3,3,0
608140548,David Gillingham,800114325,Roger Whiteley,3,3,0
608140548,David Gillingham,948504778,Jon Fordham,3,3,0
608140548,David Gillingham,954080507,Sam Corsby,3,3,0
612265840,Paul Honeysett,649240057,Mike Childs,3,2,1
613893140,Matt Warner,669385277,Steve Towler,3,2,1
613893140,Matt Warner,867613624,Ian Dunhill,3,1,2
613893140,Matt Warner,910809545,Blake Harman,3,2,1
613893140,Matt Warner,929636592,Danny Wilson,3,2,1
617751649,Lee Simpson,670256222,Connor Anderson,3,1,2
619390728,Steve Stylianou,670256222,Connor Anderson,3,2,1
619390728,Steve Stylianou,752709358,Chris Mason,3,1,2
619390728,Steve Stylianou,766684900,John Gillard,3,1,2
619390728,Steve Stylianou,802242736,Steve Hughes,3,3,0
619390728,Steve Stylianou,963958265,Rodney Moogan,3,2,1
646410961,Paul Scorer,680442672,Scott Lawson,3,2,1
646410961,Paul Scorer,732321233,Nathan Brooks,3,2,1
646410961,Paul Scorer,963958265,Rodney Moogan,3,3,0
649240057,Mike Childs,676753614,Don James,3,2,1
654650203,Alan O'Sullivan,809568302,Mark Johnson,3,0,3
654650203,Alan O'Sullivan,836895047,Ian McKay,3,1,2
661923191,Steve Gardner,831214643,Tony Shipley,3,1,2
666735933,Mike Collier,752709358,Chris Mason,3,2,1
666735933,Mike Collier,957784480,Harry Banks,3,2,1
669385277,Steve Towler,971308746,Clive Harman,3,2,1
670034050,John Muzio,736672590,Dean Perry,3,2,1
670034050,John Muzio,858283721,Dave Dunstall,3,2,1
670034050,John Muzio,963206772,Dean Moore,3,0,3
670256222,Connor Anderson,800114325,Roger Whiteley,3,1,2
670256222,Connor Anderson,809568302,Mark Johnson,3,3,0
670256222,Connor Anderson,948504778,Jon Fordham,3,3,0
670256222,Connor Anderson,954297832,Pav Sareen,3,3,0
670870044,David Flanagan,880982797,Ray Hunter,3,3,0
677110925,Jake Dunstall,833156731,Jez Saunders,3,2,1
677110925,Jake Dunstall,963206772,Dean Moore,3,1,2
688252012,Sean Cooper,704007508,Alan Muir,3,0,3
688252012,Sean Cooper,815023707,David Senior,3,0,3
688252012,Sean Cooper,880982797,Ray Hunter,3,3,0
688252012,Sean Cooper,970786910,Kevin Sorrell,3,2,1
688252012,Sean Cooper,978156264,Bob Paine,3,2,1
688778183,Dean Paice,719124015,Tony Power,3,3,0
688778183,Dean Paice,800114325,Roger Whiteley,3,1,2
688778183,Dean Paice,836895047,Ian McKay,3,1,2
688778183,Dean Paice,852327692,Andy Fletcher,3,3,0
688778183,Dean Paice,971308746,Clive Harman,3,3,0
704007508,Alan Muir,717256135,Trevor Pickard,3,0,3
704007508,Alan Muir,724342701,Nigel Lilley,3,3,0
704007508,Alan Muir,910809545,Blake Harman,3,3,0
713064363,John Trory,809984729,Neil Scutt,3,1,2
717256135,Trevor Pickard,802242736,Steve Hughes,3,1,2
717256135,Trevor Pickard,837429850,Paul Beecham,3,0,3
717256135,Trevor Pickard,949603489,Pete Bennett,3,2,1
717256135,Trevor Pickard,957784480,Harry Banks,3,1,2
717256135,Trevor Pickard,974385564,Danny Booker,3,0,3
719124015,Tony Power,721321839,Matt Peake,3,2,1
719124015,Tony Power,835713833,Olly Stewart,3,1,2
719124015,Tony Power,848997254,Tom Parker,3,1,2
719124015,Tony Power,880982797,Ray Hunter,3,1,2
719124015,Tony Power,970786910,Kevin Sorrell,3,1,2
721321839,Matt Peake,954080507,Sam Corsby,3,1,2
724342701,Nigel Lilley,835713833,Olly Stewart,3,0,3
728690686,Rick Rothschild,845758589,Charlie James,3,2,1
732321233,Nathan Brooks,752709358,Chris Mason,3,0,3
732321233,Nathan Brooks,797962517,Dave Lewis,3,1,2
732321233,Nathan Brooks,809568302,Mark Johnson,3,2,1
732415457,Barry Hall,737709582,Tony Browne,3,2,1
732415457,Barry Hall,746406369,Loz O'Keefe,3,1,2
732415457,Barry Hall,800114325,Roger Whiteley,3,2,1
732415457,Barry Hall,805165161,Steve Owen,3,2,1
732415457,Barry Hall,809647573,John Taylor,3,3,0
733453947,Phil Canham,866506631,Mark Smith,3,0,3
733453947,Phil Canham,910809545,Blake Harman,3,0,3
733453947,Phil Canham,951468676,Steve Burchett,3,1,2
736672590,Dean Perry,836895047,Ian McKay,3,0,3
737709582,Tony Browne,757827662,Clive Freestone,3,2,1
737709582,Tony Browne,807603289,Kevin Gardner,3,2,1
737709582,Tony Browne,835713833,Olly Stewart,3,0,3
745152759,Kevin Jewell,936624299,Peter Gallant,3,0,3
745152759,Kevin Jewell,966905561,Tony Dade,3,0,3
745152759,Kevin Jewell,971308746,Clive Harman,3,0,3
748064029,Paul Hughes,876526526,Ash Bull,3,1,2
752709358,Chris Mason,825399596,Pat Adams,3,3,0
752709358,Chris Mason,948504778,Jon Fordham,3,3,0
754250007,Freddie Blunden,766684900,John Gillard,3,1,2
754250007,Freddie Blunden,797313851,Dave Anderson,3,3,0
754250007,Freddie Blunden,876526526,Ash Bull,3,1,2
766684900,John Gillard,947143243,Chris Davis,3,2,1
773216781,Sean Payne,800114325,Roger Whiteley,3,2,1
773216781,Sean Payne,974385564,Danny Booker,3,2,1
794630189,Mark Coles,809568302,Mark Johnson,3,3,0
797962517,Dave Lewis,947143243,Chris Davis,3,1,2
797962517,Dave Lewis,948504778,Jon Fordham,3,2,1
800114325,Roger Whiteley,809647573,John Taylor,3,2,1
800114325,Roger Whiteley,848997254,Tom Parker,3,2,1
800114325,Roger Whiteley,963206772,Dean Moore,3,2,1
802242736,Steve Hughes,837429850,Paul Beecham,3,3,0
802242736,Steve Hughes,876526526,Ash Bull,3,0,3
802242736,Steve Hughes,957784480,Harry Banks,3,1,2
804381932,Ryan Harman,978156264,Bob Paine,3,2,1
809568302,Mark Johnson,957784480,Harry Banks,3,1,2
809647573,John Taylor,867613624,Ian Dunhill,3,1,2
809984729,Neil Scutt,867613624,Ian Dunhill,3,1,2
815023707,David Senior,943667183,John Stone,3,2,1
820231590,Alan Rook,858283721,Dave Dunstall,3,0,3
820231590,Alan Rook,867613624,Ian Dunhill,3,0,3
820231590,Alan Rook,880982797,Ray Hunter,3,2,1
820231590,Alan Rook,910809545,Blake Harman,3,1,2
820231590,Alan Rook,943667183,John Stone,3,2,1
820231590,Alan Rook,978156264,Bob Paine,3,2,1
822983250,Alasdair Pratt,929636592,Danny Wilson,3,2,1
825399596,Pat Adams,948504778,Jon Fordham,3,1,2
831214643,Tony Shipley,845758589,Charlie James,3,2,1
833156731,Jez Saunders,889234854,Paul Smith,3,1,2
835713833,Olly Stewart,845758589,Charlie James,3,3,0
835713833,Olly Stewart,866506631,Mark Smith,3,2,1
836895047,Ian McKay,910809545,Blake Harman,3,2,1
844676925,Kieran Williams,845758589,Charlie James,3,1,2
844676925,Kieran Williams,899206834,Jez Downs,3,3,0
844676925,Kieran Williams,954080507,Sam Corsby,3,2,1
845758589,Charlie James,953512654,Les Berry,3,3,0
848997254,Tom Parker,974385564,Danny Booker,3,1,2
865803068,Dave Jones,948504778,Jon Fordham,3,3,0
865803068,Dave Jones,957784480,Harry Banks,3,2,1
873916947,Geoff Akehurst,954639632,Derek Budde,3,0,3
873916947,Geoff Akehurst,971308746,Clive Harman,3,1,2
873916947,Geoff Akehurst,974385564,Danny Booker,3,0,3
878576746,Jon Hall,949603489,Pete Bennett,3,2,1
878576746,Jon Hall,954080507,Sam Corsby,3,1,2
880982797,Ray Hunter,963206772,Dean Moore,3,1,2
884365412,Dave Haslam,957784480,Harry Banks,3,0,3
884365412,Dave Haslam,974385564,Danny Booker,3,0,3
884374645,Wayne Iddon,936624299,Peter Gallant,3,3,0
899206834,Jez Downs,970786910,Kevin Sorrell,3,0,3
910809545,Blake Harman,966905561,Tony Dade,3,2,1
943667183,John Stone,971308746,Clive Harman,3,0,3
943667183,John Stone,978156264,Bob Paine,3,1,2
947143243,Chris Davis,948504778,Jon Fordham,3,2,1
949603489,Pete Bennett,954080507,Sam Corsby,3,1,2
954297832,Pav Sareen,957784480,Harry Banks,3,2,1
1,Tim Dawes,384960657,Dave Lewney,2,0,2
1,Tim Dawes,444639447,Andy Wong,2,0,2
1,Tim Dawes,837429850,Paul Beecham,2,1,1
1,Tim Dawes,963958265,Rodney Moogan,2,1,1
3,Neal Gozzett,14,Michael West,2,0,2
3,Neal Gozzett,59858690,James Constable,2,2,0
3,Neal Gozzett,837429850,Paul Beecham,2,2,0
5,Paul Osiecki,133,Darren Bradley,2,2,0
5,Paul Osiecki,617751649,Lee Simpson,2,0,2
5,Paul Osiecki,619390728,Steve Stylianou,2,0,2
5,Paul Osiecki,837429850,Paul Beecham,2,2,0
6,Dan Stirling,9,Michael Cheung,2,2,0
6,Dan Stirling,16,Mick Beck,2,1,1
6,Dan Stirling,90176364,David Page,2,2,0
6,Dan Stirling,112887737,Pip Akehurst,2,2,0
6,Dan Stirling,515186402,Ben Evans,2,0,2
6,Dan Stirling,600385553,Darren Welfare,2,1,1
6,Dan Stirling,666735933,Mike Collier,2,1,1
6,Dan Stirling,748064029,Paul Hughes,2,1,1
6,Dan Stirling,957784480,Harry Banks,2,1,1
8,Colin Barber,192463126,Gerry Lindsey,2,2,0
8,Colin Barber,754250007,Freddie Blunden,2,0,2
8,Colin Barber,766684900,John Gillard,2,0,2
8,Colin Barber,809568302,Mark Johnson,2,0,2
9,Michael Cheung,17,Tony Funnell,2,1,1
9,Michael Cheung,393,Mark Purser,2,1,1
9,Michael Cheung,5820499,Paul Bartlett,2,0,2
9,Michael Cheung,60575249,Ash Thurmer,2,2,0
9,Michael Cheung,748064029,Paul Hughes,2,0,2
14,Michael West,222,John Newnhan,2,2,0
14,Michael West,90176364,David Page,2,2,0
14,Michael West,345558874,Zack Richardson,2,2,0
14,Michael West,748064029,Paul Hughes,2,1,1
14,Michael West,766684900,John Gillard,2,1,1
16,Mick Beck,89,Mike Atkins,2,0,2
16,Mick Beck,326,Stefan Chandler,2,2,0
16,Mick Beck,492,Malcolm Beal,2,0,2
16,Mick Beck,5820499,Paul Bartlett,2,2,0
16,Mick Beck,11133032,Simon Dent,2,0,2
16,Mick Beck,133207947,Jake Richardson,2,0,2
16,Mick Beck,141540226,Pete Hazell,2,0,2
16,Mick Beck,266591683,Chris Roche,2,2,0
16,Mick Beck,279543944,Peter Maurice,2,2,0
16,Mick Beck,515186402,Ben Evans,2,0,2
16,Mick Beck,567316488,Lee Millyard,2,2,0
16,Mick Beck,579164381,Danny Cattell,2,0,2
16,Mick Beck,600385553,Darren Welfare,2,0,2
16,Mick Beck,688778183,Dean Paice,2,0,2
16,Mick Beck,810143915,Ben Welfare,2,2,0
19,Andros Harilaou,137,Ricky Beecham,2,1,1
19,Andros Harilaou,600385553,Darren Welfare,2,1,1
22,Tim Shutt,608140548,David Gillingham,2,1,1
22,Tim Shutt,619390728,Steve Stylianou,2,0,2
22,Tim Shutt,963958265,Rodney Moogan,2,1,1
28,Simon Parker,231975313,Danny English,2,1,1
28,Simon Parker,889234854,Paul Smith,2,0,2
31,Gary Dartnell,149,Tony Nealgrove,2,2,0
31,Gary Dartnell,183,Simon Alexander,2,1,1
31,Gary Dartnell,866506631,Mark Smith,2,1,1
31,Gary Dartnell,899206834,Jez Downs,2,1,1
37,Kieran Tighe,83,Eric Gumbrell,2,2,0
37,Kieran Tighe,180,Pat Sweeney,2,1,1
37,Kieran Tighe,199,Mark Holloway,2,2,0
37,Kieran Tighe,16253983,Tony Simmonds,2,0,2
38,Rob Bowden,202,Bob Firth,2,2,0
38,Rob Bowden,288,Pete Elliott,2,2,0
38,Rob Bowden,420230435,Jack Fielder,2,0,2
38,Rob Bowden,573567936,Steve Marriott,2,2,0
38,Rob Bowden,612265840,Paul Honeysett,2,1,1
38,Rob Bowden,670034050,John Muzio,2,1,1
38,Rob Bowden,915035871,Kevin Graysmark,2,0,2
39,Steve Goldthorpe,84,Gavin McCubbin,2,2,0
39,Steve Goldthorpe,188,Phil Turner,2,0,2
40,Shykul Malique,316,Paul Redgate,2,2,0
40,Shykul Malique,805165161,Steve Owen,2,0,2
40,Shykul Malique,873916947,Geoff Akehurst,2,1,1
44,John McGuigan,248,R. Teagle,2,1,1
44,John McGuigan,275738778,John Da Silva,2,1,1
49,Daniel James,84,Gavin McCubbin,2,2,0
49,Daniel James,102,Reece Childs,2,1,1
49,Daniel James,281,Bob Rumble,2,1,1
49,Daniel James,287,Chris Johns,2,0,2
49,Daniel James,288,Pete Elliott,2,2,0
49,Daniel James,490170224,Jamie Matthews,2,0,2
49,Daniel James,815023707,David Senior,2,2,0
61,Paul Gander,70,Michael Turner-Lee,2,1,1
61,Paul Gander,235,Derek Conley,2,2,0
61,Paul Gander,237,Paul Wilson,2,0,2
61,Paul Gander,60575249,Ash Thurmer,2,0,2
61,Paul Gander,172646809,Robin Powell,2,2,0
61,Paul Gander,231975313,Danny English,2,0,2
61,Paul Gander,278731588,Lester Grice,2,1,1
61,Paul Gander,463709832,Danny Wong,2,0,2
61,Paul Gander,608140548,David Gillingham,2,1,1
61,Paul Gander,688778183,Dean Paice,2,0,2
61,Paul Gander,880982797,Ray Hunter,2,1,1
63,Colin Penson,116,Ken Mason,2,2,0
63,Colin Penson,193,Gary Goodman,2,2,0
63,Colin Penson,315,Peter Stevens,2,1,1
63,Colin Penson,231445676,Tony Paice,2,2,0
63,Colin Penson,503528426,Larry Maloney,2,1,1
63,Colin Penson,670256222,Connor Anderson,2,0,2
63,Colin Penson,688778183,Dean Paice,2,0,2
65,Paul Hudson,115,Jim Collins,2,2,0
65,Paul Hudson,463709832,Danny Wong,2,1,1
65,Paul Hudson,529382351,Greg Foat,2,2,0
65,Paul Hudson,734416600,DON PENALVER,2,1,1
65,Paul Hudson,850059806,Heng Wong,2,1,1
70,Michael Turner-Lee,117,Joe Collins,2,1,1
70,Michael Turner-Lee,90176364,David Page,2,1,1
70,Michael Turner-Lee,231445676,Tony Paice,2,1,1
70,Michael Turner-Lee,608140548,David Gillingham,2,0,2
70,Michael Turner-Lee,670256222,Connor Anderson,2,0,2
70,Michael Turner-Lee,688778183,Dean Paice,2,0,2
70,Michael Turner-Lee,732321233,Nathan Brooks,2,0,2
70,Michael Turner-Lee,809647573,John Taylor,2,0,2
75,Chris Rea,110039677,Mick Miller,2,0,2
75,Chris Rea,174147986,Lee Cliff,2,1,1
75,Chris Rea,810143915,Ben Welfare,2,0,2
76,David Rea,108,John Wooller,2,1,1
76,David Rea,110039677,Mick Miller,2,1,1
76,David Rea,172646809,Robin Powell,2,1,1
76,David Rea,412256116,Andy Sutton,2,0,2
76,David Rea,423038309,Ian Fennell,2,2,0
76,David Rea,537640521,Ian Stoner,2,2,0
76,David Rea,845537273,Dave Gridley,2,0,2
78,Kevin Baker,181,Dave Roughley,2,0,2
78,Kevin Baker,300,Graham Smart,2,1,1
78,Kevin Baker,110039677,Mick Miller,2,1,1
78,Kevin Baker,213264678,Martin Hall,2,0,2
78,Kevin Baker,386517733,Ady Halley,2,0,2
78,Kevin Baker,436708540,Bob Henley,2,1,1
78,Kevin Baker,579164381,Danny Cattell,2,1,1
78,Kevin Baker,836895047,Ian McKay,2,0,2
78,Kevin Baker,858283721,Dave Dunstall,2,0,2
78,Kevin Baker,970786910,Kevin Sorrell,2,0,2
80,Dave Wells,447,Barry Riddles,2,1,1
80,Dave Wells,32061370,Toby Prince-Iles,2,0,2
80,Dave Wells,56252722,Dave Pither,2,1,1
80,Dave Wells,101751030,Simon Uddin,2,2,0
80,Dave Wells,392533233,Jack Wright,2,0,2
80,Dave Wells,688252012,Sean Cooper,2,0,2
80,Dave Wells,746406369,Loz O'Keefe,2,0,2
80,Dave Wells,943667183,John Stone,2,2,0
81,Nick Bollingbroke,411473516,Ray Canham,2,2,0
81,Nick Bollingbroke,915035871,Kevin Graysmark,2,0,2
82,Gavin Williams,188,Phil Turner,2,1,1
83,Eric Gumbrell,181,Dave Roughley,2,0,2
83,Eric Gumbrell,202,Bob Firth,2,1,1
83,Eric Gumbrell,301960429,Brian Collins,2,0,2
83,Eric Gumbrell,889234854,Paul Smith,2,1,1
83,Eric Gumbrell,963206772,Dean Moore,2,0,2
83,Eric Gumbrell,980908578,Jake Whatman,2,0,2
84,Gavin McCubbin,102,Reece Childs,2,1,1
84,Gavin McCubbin,239,Mick Lucas,2,0,2
84,Gavin McCubbin,247,Mick Justice,2,0,2
84,Gavin McCubbin,284,Ray Bradley,2,1,1
84,Gavin McCubbin,340,A. Bartup,2,0,2
84,Gavin McCubbin,384,Bryan Beck,2,1,1
84,Gavin McCubbin,442,Harvey Tuck,2,1,1
84,Gavin McCubbin,479,Brian Welsh,2,0,2
84,Gavin McCubbin,204951513,Mike Holding,2,0,2
84,Gavin McCubbin,275738778,John Da Silva,2,0,2
84,Gavin McCubbin,401846353,Frank McHugh,2,2,0
84,Gavin McCubbin,430890681,Malcolm Cooper,2,0,2
84,Gavin McCubbin,498330760,Mo Collins,2,2,0
84,Gavin McCubbin,535728699,Fred Cooper,2,1,1
84,Gavin McCubbin,688252012,Sean Cooper,2,2,0
84,Gavin McCubbin,910809545,Blake Harman,2,1,1
84,Gavin McCubbin,936624299,Peter Gallant,2,1,1
88,Steve Collins,367,Chris Dolding,2,0,2
88,Steve Collins,114184042,Ian Smith,2,2,0
88,Steve Collins,202090738,Alan Head,2,1,1
88,Steve Collins,231445676,Tony Paice,2,1,1
88,Steve Collins,670256222,Connor Anderson,2,0,2
88,Steve Collins,719124015,Tony Power,2,1,1
88,Steve Collins,766684900,John Gillard,2,0,2
89,Mike Atkins,279543944,Peter Maurice,2,1,1
89,Mike Atkins,323907964,Russ Hughes,2,1,1
89,Mike Atkins,567316488,Lee Millyard,2,2,0
89,Mike Atkins,600385553,Darren Welfare,2,0,2
89,Mike Atkins,688778183,Dean Paice,2,2,0
89,Mike Atkins,948504778,Jon Fordham,2,2,0
92,Dale Thomas,281,Bob Rumble,2,0,2
92,Dale Thomas,291,John Taylor,2,0,2
92,Dale Thomas,28382047,Steve Harrington,2,0,2
92,Dale Thomas,39289507,Mick Laughlin,2,0,2
92,Dale Thomas,266477517,Tony Baxter,2,0,2
92,Dale Thomas,386517733,Ady Halley,2,0,2
92,Dale Thomas,649240057,Mike Childs,2,1,1
92,Dale Thomas,732415457,Barry Hall,2,0,2
92,Dale Thomas,954639632,Derek Budde,2,1,1
93,Derek Hazelgrove,281,Bob Rumble,2,1,1
94,Don McCreery,39289507,Mick Laughlin,2,1,1
96,Dave Kellett,101,Jason Childs,2,2,0
96,Dave Kellett,28382047,Steve Harrington,2,2,0
96,Dave Kellett,39289507,Mick Laughlin,2,1,1
96,Dave Kellett,229719541,Scott Manning,2,1,1
96,Dave Kellett,394906196,Mick Mabbitt,2,2,0
96,Dave Kellett,537640521,Ian Stoner,2,2,0
96,Dave Kellett,613893140,Matt Warner,2,1,1
96,Dave Kellett,728690686,Rick Rothschild,2,2,0
96,Dave Kellett,936624299,Peter Gallant,2,2,0
96,Dave Kellett,951468676,Steve Burchett,2,0,2
97,Shaun Winsor,102,Reece Childs,2,1,1
97,Shaun Winsor,182,Brian Welfare,2,2,0
97,Shaun Winsor,428,Mike Fletcher,2,2,0
97,Shaun Winsor,160950731,Locky McCurdy,2,1,1
97,Shaun Winsor,223983583,Carl Wentworth,2,2,0
97,Shaun Winsor,410854609,Dave Lowe,2,0,2
97,Shaun Winsor,613893140,Matt Warner,2,1,1
97,Shaun Winsor,670034050,John Muzio,2,0,2
97,Shaun Winsor,676753614,Don James,2,1,1
97,Shaun Winsor,746406369,Loz O'Keefe,2,0,2
97,Shaun Winsor,936624299,Peter Gallant,2,2,0
97,Shaun Winsor,966905561,Tony Dade,2,1,1
98,Tony Collins,149,Tony Nealgrove,2,2,0
98,Tony Collins,179,Mick Jones,2,0,2
98,Tony Collins,180,Pat Sweeney,2,0,2
98,Tony Collins,239,Mick Lucas,2,1,1
98,Tony Collins,288,Pete Elliott,2,0,2
98,Tony Collins,381,Aaron Jones,2,2,0
98,Tony Collins,101751030,Simon Uddin,2,2,0
98,Tony Collins,386517733,Ady Halley,2,0,2
98,Tony Collins,410854609,Dave Lowe,2,2,0
98,Tony Collins,417786644,Eddie Collins,2,1,1
98,Tony Collins,479705187,Keith McQueen,2,2,0
98,Tony Collins,613893140,Matt Warner,2,1,1
98,Tony Collins,978156264,Bob Paine,2,2,0
101,Jason Childs,291,John Taylor,2,1,1
101,Jason Childs,844676925,Kieran Williams,2,0,2
102,Reece Childs,284,Ray Bradley,2,2,0
102,Reece Childs,286,Paul Baker,2,1,1
102,Reece Childs,386,Sam Hains,2,1,1
102,Reece Childs,445,Lachlan Monroe,2,2,0
102,Reece Childs,160950731,Locky McCurdy,2,1,1
102,Reece Childs,266477517,Tony Baxter,2,2,0
102,Reece Childs,401846353,Frank McHugh,2,2,0
102,Reece Childs,479705187,Keith McQueen,2,2,0
102,Reece Childs,567624732,Dave Brampton,2,0,2
102,Reece Childs,820231590,Alan Rook,2,0,2
108,John Wooller,193,Gary Goodman,2,1,1
108,John Wooller,235,Derek Conley,2,2,0
108,John Wooller,529382351,Greg Foat,2,1,1
108,John Wooller,608140548,David Gillingham,2,1,1
108,John Wooller,880982797,Ray Hunter,2,1,1
115,Jim Collins,202090738,Alan Head,2,0,2
115,Jim Collins,831214643,Tony Shipley,2,1,1
115,Jim Collins,850059806,Heng Wong,2,1,1
116,Ken Mason,198,Chris Playford,2,0,2
117,Joe Collins,60575249,Ash Thurmer,2,1,1
117,Joe Collins,279543944,Peter Maurice,2,2,0
117,Joe Collins,947620111,Neil Cutler,2,1,1
121,Mike Barnett,173,Dave Alderton,2,1,1
121,Mike Barnett,315,Peter Stevens,2,0,2
121,Mike Barnett,321,Mick Ingram,2,1,1
121,Mike Barnett,504,Aaron Immerson,2,1,1
121,Mike Barnett,382970973,Paul Shaw,2,0,2
121,Mike Barnett,411473516,Ray Canham,2,1,1
121,Mike Barnett,423038309,Ian Fennell,2,0,2
121,Mike Barnett,574248035,Tony Mulhern,2,1,1
121,Mike Barnett,732321233,Nathan Brooks,2,1,1
121,Mike Barnett,884365412,Dave Haslam,2,0,2
121,Mike Barnett,889234854,Paul Smith,2,0,2
121,Mike Barnett,954080507,Sam Corsby,2,0,2
121,Mike Barnett,971308746,Clive Harman,2,2,0
123,Gary Burton,174,Brian Grant,2,0,2
124,Dave Tristram,297,S. Grogan,2,1,1
124,Dave Tristram,117247901,Dave Verey,2,0,2
124,Dave Tristram,225850882,John McLellan,2,0,2
124,Dave Tristram,327948141,Ross Etheridge,2,1,1
124,Dave Tristram,411473516,Ray Canham,2,1,1
124,Dave Tristram,451309825,Maurice Wickens,2,1,1
124,Dave Tristram,455401154,Kai Ellis,2,1,1
127,Dave Turner,282,Adam Harrild,2,1,1
127,Dave Turner,266477517,Tony Baxter,2,1,1
133,Darren Bradley,717256135,Trevor Pickard,2,0,2
133,Darren Bradley,802242736,Steve Hughes,2,1,1
136,Dave Bonwick,365,Dan Buckwell,2,1,1
136,Dave Bonwick,431,Darren Jordan,2,0,2
136,Dave Bonwick,323907964,Russ Hughes,2,0,2
136,Dave Bonwick,384960657,Dave Lewney,2,1,1
136,Dave Bonwick,619390728,Steve Stylianou,2,0,2
136,Dave Bonwick,748064029,Paul Hughes,2,0,2
136,Dave Bonwick,802242736,Steve Hughes,2,0,2
136,Dave Bonwick,957784480,Harry Banks,2,0,2
136,Dave Bonwick,963958265,Rodney Moogan,2,1,1
137,Ricky Beecham,384960657,Dave Lewney,2,0,2
137,Ricky Beecham,766684900,John Gillard,2,0,2
138,Jack McCulloch,173,Dave Alderton,2,0,2
138,Jack McCulloch,180,Pat Sweeney,2,0,2
138,Jack McCulloch,182,Brian Welfare,2,2,0
138,Jack McCulloch,295,Graham Still,2,0,2
147,K. Patmore,464085958,Gerwyn Bowen,2,1,1
149,Tony Nealgrove,181,Dave Roughley,2,0,2
149,Tony Nealgrove,288,Pete Elliott,2,0,2
149,Tony Nealgrove,124523642,Tom Hayes,2,0,2
149,Tony Nealgrove,319057545,Brendan Lambe,2,0,2
149,Tony Nealgrove,429738563,Adam Buckingham,2,1,1
149,Tony Nealgrove,546362444,Anthony Trory,2,1,1
149,Tony Nealgrove,858283721,Dave Dunstall,2,1,1
153,Tony Leach,177,John Regan,2,0,2
153,Tony Leach,110039677,Mick Miller,2,0,2
153,Tony Leach,351143642,Michael Palmer,2,0,2
153,Tony Leach,364867274,Dave Lucking,2,1,1
153,Tony Leach,506320151,Frank Taylor,2,0,2
153,Tony Leach,845537273,Dave Gridley,2,0,2
157,Stewart Swanton,175,Dudley Rignall,2,1,1
157,Stewart Swanton,412256116,Andy Sutton,2,0,2
157,Stewart Swanton,436708540,Bob Henley,2,1,1
164,Neil Bushell,239,Mick Lucas,2,2,0
164,Neil Bushell,556095121,Tom Wright,2,0,2
171,Darren Bell,34787509,Dave McCarthy,2,0,2
171,Darren Bell,59858690,James Constable,2,1,1
171,Darren Bell,384960657,Dave Lewney,2,2,0
171,Darren Bell,764177688,Barry Martin,2,0,2
173,Dave Alderton,295,Graham Still,2,2,0
173,Dave Alderton,319,John Lojo,2,1,1
173,Dave Alderton,479,Brian Welsh,2,1,1
173,Dave Alderton,26970170,Kai Michael,2,1,1
173,Dave Alderton,110039677,Mick Miller,2,2,0
173,Dave Alderton,225850882,John McLellan,2,2,0
173,Dave Alderton,291816585,Jim Somers,2,1,1
173,Dave Alderton,412256116,Andy Sutton,2,2,0
173,Dave Alderton,728690686,Rick Rothschild,2,0,2
173,Dave Alderton,733453947,Phil Canham,2,0,2
173,Dave Alderton,736672590,Dean Perry,2,1,1
173,Dave Alderton,809647573,John Taylor,2,1,1
173,Dave Alderton,878576746,Jon Hall,2,1,1
173,Dave Alderton,954080507,Sam Corsby,2,2,0
174,Brian Grant,297,S. Grogan,2,2,0
174,Brian Grant,301,Terry Grant,2,2,0
174,Brian Grant,174147986,Lee Cliff,2,1,1
174,Brian Grant,231975313,Danny English,2,0,2
174,Brian Grant,412256116,Andy Sutton,2,1,1
174,Brian Grant,444350794,Richard Freeman,2,2,0
174,Brian Grant,878576746,Jon Hall,2,1,1
174,Brian Grant,884365412,Dave Haslam,2,1,1
175,Dudley Rignall,319,John Lojo,2,1,1
175,Dudley Rignall,337,Adam Williams,2,2,0
175,Dudley Rignall,213264678,Martin Hall,2,1,1
177,John Regan,272,Carlo Lupi,2,0,2
177,John Regan,3508579,John Murray,2,1,1
177,John Regan,351143642,Michael Palmer,2,2,0
177,John Regan,436708540,Bob Henley,2,1,1
177,John Regan,506320151,Frank Taylor,2,1,1
177,John Regan,579164381,Danny Cattell,2,0,2
177,John Regan,954080507,Sam Corsby,2,1,1
179,Mick Jones,275738778,John Da Silva,2,0,2
179,Mick Jones,670034050,John Muzio,2,1,1
179,Mick Jones,733453947,Phil Canham,2,0,2
179,Mick Jones,915035871,Kevin Graysmark,2,0,2
179,Mick Jones,963206772,Dean Moore,2,0,2
180,Pat Sweeney,225247539,Barry Knight,2,2,0
180,Pat Sweeney,670034050,John Muzio,2,2,0
181,Dave Roughley,199,Mark Holloway,2,2,0
181,Dave Roughley,124523642,Tom Hayes,2,1,1
181,Dave Roughley,174147986,Lee Cliff,2,0,2
181,Dave Roughley,223983583,Carl Wentworth,2,1,1
181,Dave Roughley,275738778,John Da Silva,2,2,0
181,Dave Roughley,382970973,Paul Shaw,2,0,2
181,Dave Roughley,464085958,Gerwyn Bowen,2,2,0
181,Dave Roughley,537640521,Ian Stoner,2,2,0
181,Dave Roughley,670034050,John Muzio,2,1,1
181,Dave Roughley,889234854,Paul Smith,2,2,0
181,Dave Roughley,899206834,Jez Downs,2,2,0
181,Dave Roughley,963206772,Dean Moore,2,0,2
182,Brian Welfare,307,Alister Morrison,2,1,1
182,Brian Welfare,315,Peter Stevens,2,0,2
182,Brian Welfare,16253983,Tony Simmonds,2,0,2
182,Brian Welfare,41461520,Luke Pooley,2,1,1
182,Brian Welfare,225247539,Barry Knight,2,2,0
182,Brian Welfare,275738778,John Da Silva,2,0,2
182,Brian Welfare,386517733,Ady Halley,2,2,0
182,Brian Welfare,537640521,Ian Stoner,2,1,1
182,Brian Welfare,573567936,Steve Marriott,2,0,2
182,Brian Welfare,598846718,Ben Sorrell,2,1,1
182,Brian Welfare,669385277,Steve Towler,2,0,2
182,Brian Welfare,833156731,Jez Saunders,2,2,0
182,Brian Welfare,873916947,Geoff Akehurst,2,2,0
182,Brian Welfare,889234854,Paul Smith,2,1,1
183,Simon Alexander,202,Bob Firth,2,1,1
183,Simon Alexander,278,Dave Fairbairn,2,1,1
183,Simon Alexander,411473516,Ray Canham,2,0,2
183,Simon Alexander,464085958,Gerwyn Bowen,2,0,2
183,Simon Alexander,713064363,John Trory,2,1,1
183,Simon Alexander,866506631,Mark Smith,2,1,1
183,Simon Alexander,889234854,Paul Smith,2,1,1
188,Phil Turner,278,Dave Fairbairn,2,0,2
188,Phil Turner,309,M. Humphries,2,1,1
188,Phil Turner,943667183,John Stone,2,2,0
190,Paul Mitchell,112887737,Pip Akehurst,2,0,2
190,Paul Mitchell,114184042,Ian Smith,2,1,1
190,Paul Mitchell,202090738,Alan Head,2,0,2
193,Gary Goodman,236,Lee Garland,2,2,0
193,Gary Goodman,266591683,Chris Roche,2,0,2
193,Gary Goodman,600385553,Darren Welfare,2,1,1
193,Gary Goodman,617751649,Lee Simpson,2,0,2
193,Gary Goodman,688778183,Dean Paice,2,2,0
193,Gary Goodman,957784480,Harry Banks,2,1,1
198,Chris Playford,279543944,Peter Maurice,2,0,2
198,Chris Playford,754250007,Freddie Blunden,2,1,1
198,Chris Playford,831214643,Tony Shipley,2,1,1
199,Mark Holloway,278,Dave Fairbairn,2,1,1
199,Mark Holloway,307,Alister Morrison,2,1,1
199,Mark Holloway,866506631,Mark Smith,2,1,1
199,Mark Holloway,899206834,Jez Downs,2,2,0
199,Mark Holloway,911104566,Steve Linton,2,2,0
199,Mark Holloway,963206772,Dean Moore,2,1,1
202,Bob Firth,16253983,Tony Simmonds,2,0,2
202,Bob Firth,117247901,Dave Verey,2,0,2
202,Bob Firth,225247539,Barry Knight,2,0,2
202,Bob Firth,275738778,John Da Silva,2,0,2
202,Bob Firth,301960429,Brian Collins,2,0,2
202,Bob Firth,364867274,Dave Lucking,2,2,0
202,Bob Firth,386517733,Ady Halley,2,1,1
202,Bob Firth,464085958,Gerwyn Bowen,2,0,2
202,Bob Firth,510918620,Robert Bowden,2,0,2
202,Bob Firth,669385277,Steve Towler,2,0,2
222,John Newnhan,96103077,Paul Norris,2,0,2
222,John Newnhan,147556923,Hong Ming Lee,2,0,2
222,John Newnhan,278731588,Lester Grice,2,0,2
222,John Newnhan,323907964,Russ Hughes,2,1,1
222,John Newnhan,384960657,Dave Lewney,2,2,0
222,John Newnhan,523395206,Jamie Lashmar,2,0,2
222,John Newnhan,600385553,Darren Welfare,2,1,1
222,John Newnhan,724342701,Nigel Lilley,2,1,1
222,John Newnhan,794630189,Mark Coles,2,1,1
222,John Newnhan,809568302,Mark Johnson,2,0,2
223,Ollie Stalley,619390728,Steve Stylianou,2,0,2
235,Derek Conley,395,Herby Burchell,2,1,1
235,Derek Conley,26970170,Kai Michael,2,1,1
235,Derek Conley,90176364,David Page,2,1,1
235,Derek Conley,112887737,Pip Akehurst,2,1,1
235,Derek Conley,114184042,Ian Smith,2,0,2
235,Derek Conley,278731588,Lester Grice,2,0,2
235,Derek Conley,279543944,Peter Maurice,2,1,1
235,Derek Conley,567316488,Lee Millyard,2,0,2
235,Derek Conley,724342701,Nigel Lilley,2,1,1
235,Derek Conley,734416600,DON PENALVER,2,1,1
236,Lee Garland,529382351,Greg Foat,2,2,0
236,Lee Garland,831214643,Tony Shipley,2,1,1
236,Lee Garland,836895047,Ian McKay,2,1,1
236,Lee Garland,880982797,Ray Hunter,2,2,0
237,Paul Wilson,278731588,Lester Grice,2,1,1
237,Paul Wilson,279543944,Peter Maurice,2,1,1
237,Paul Wilson,608140548,David Gillingham,2,0,2
237,Paul Wilson,800114325,Roger Whiteley,2,2,0
239,Mick Lucas,390,Luke Cann,2,1,1
239,Mick Lucas,466,Ben Fielder,2,0,2
239,Mick Lucas,516,Lee Fairclough,2,1,1
239,Mick Lucas,56252722,Dave Pither,2,1,1
239,Mick Lucas,409212679,Mark Chapman,2,0,2
239,Mick Lucas,479705187,Keith McQueen,2,0,2
239,Mick Lucas,844676925,Kieran Williams,2,0,2
244,Dave Burchett,411473516,Ray Canham,2,1,1
244,Dave Burchett,833156731,Jez Saunders,2,1,1
244,Dave Burchett,915035871,Kevin Graysmark,2,1,1
247,Mick Justice,282,Adam Harrild,2,2,0
247,Mick Justice,442,Harvey Tuck,2,1,1
247,Mick Justice,39289507,Mick Laughlin,2,2,0
247,Mick Justice,101751030,Simon Uddin,2,2,0
247,Mick Justice,144776055,Brian Wilkes,2,0,2
247,Mick Justice,266477517,Tony Baxter,2,1,1
247,Mick Justice,275738778,John Da Silva,2,0,2
247,Mick Justice,360777082,Mark Bishop,2,0,2
247,Mick Justice,392533233,Jack Wright,2,0,2
247,Mick Justice,417786644,Eddie Collins,2,1,1
247,Mick Justice,506581042,Glen Dartnell,2,1,1
247,Mick Justice,688252012,Sean Cooper,2,1,1
247,Mick Justice,815023707,David Senior,2,2,0
247,Mick Justice,873916947,Geoff Akehurst,2,1,1
248,R. Teagle,316,Paul Redgate,2,1,1
248,R. Teagle,293577764,Dave Crosskey,2,0,2
248,R. Teagle,845758589,Charlie James,2,1,1
272,Carlo Lupi,114184042,Ian Smith,2,1,1
272,Carlo Lupi,213264678,Martin Hall,2,0,2
272,Carlo Lupi,412256116,Andy Sutton,2,2,0
272,Carlo Lupi,661923191,Steve Gardner,2,2,0
275,Brian Balchin,340,A. Bartup,2,1,1
275,Brian Balchin,229719541,Scott Manning,2,0,2
275,Brian Balchin,411473516,Ray Canham,2,1,1
275,Brian Balchin,936624299,Peter Gallant,2,1,1
278,Dave Fairbairn,223983583,Carl Wentworth,2,1,1
278,Dave Fairbairn,386517733,Ady Halley,2,1,1
278,Dave Fairbairn,417786644,Eddie Collins,2,1,1
278,Dave Fairbairn,820231590,Alan Rook,2,2,0
278,Dave Fairbairn,889234854,Paul Smith,2,1,1
278,Dave Fairbairn,951468676,Steve Burchett,2,0,2
279,Tony Slark,28382047,Steve Harrington,2,0,2
279,Tony Slark,246154671,Alan Gunn,2,0,2
279,Tony Slark,319057545,Brendan Lambe,2,0,2
280,Terry Slark,266477517,Tony Baxter,2,0,2
280,Terry Slark,649240057,Mike Childs,2,0,2
281,Bob Rumble,390,Luke Cann,2,1,1
281,Bob Rumble,266477517,Tony Baxter,2,1,1
281,Bob Rumble,479705187,Keith McQueen,2,0,2
281,Bob Rumble,943667183,John Stone,2,0,2
282,Adam Harrild,316,Paul Redgate,2,2,0
282,Adam Harrild,415524562,Dave King,2,2,0
282,Adam Harrild,809984729,Neil Scutt,2,1,1
282,Adam Harrild,815023707,David Senior,2,2,0
282,Adam Harrild,844676925,Kieran Williams,2,0,2
284,Ray Bradley,356,Scott Harris,2,0,2
284,Ray Bradley,28382047,Steve Harrington,2,1,1
284,Ray Bradley,227209116,Peter Rawlinson,2,0,2
284,Ray Bradley,490170224,Jamie Matthews,2,0,2
284,Ray Bradley,498330760,Mo Collins,2,0,2
284,Ray Bradley,929636592,Danny Wilson,2,0,2
285,Pete Davie,327,Harold Franks,2,0,2
285,Pete Davie,32061370,Toby Prince-Iles,2,2,0
285,Pete Davie,39289507,Mick Laughlin,2,0,2
285,Pete Davie,160950731,Locky McCurdy,2,0,2
285,Pete Davie,401846353,Frank McHugh,2,2,0
285,Pete Davie,410854609,Dave Lowe,2,0,2
285,Pete Davie,498330760,Mo Collins,2,2,0
285,Pete Davie,820231590,Alan Rook,2,2,0
286,Paul Baker,288,Pete Elliott,2,0,2
286,Paul Baker,327,Harold Franks,2,0,2
286,Paul Baker,294944526,Rob Teanby,2,0,2
286,Paul Baker,746406369,Loz O'Keefe,2,1,1
286,Paul Baker,978156264,Bob Paine,2,1,1
287,Chris Johns,266477517,Tony Baxter,2,2,0
287,Chris Johns,490170224,Jamie Matthews,2,2,0
287,Chris Johns,612265840,Paul Honeysett,2,1,1
287,Chris Johns,676753614,Don James,2,2,0
288,Pete Elliott,386517733,Ady Halley,2,0,2
288,Pete Elliott,479705187,Keith McQueen,2,2,0
288,Pete Elliott,490170224,Jamie Matthews,2,1,1
288,Pete Elliott,510918620,Robert Bowden,2,0,2
288,Pete Elliott,612265840,Paul Honeysett,2,2,0
288,Pete Elliott,815023707,David Senior,2,1,1
288,Pete Elliott,845758589,Charlie James,2,1,1
292,Jim Mulcahey,371,Laurence Park,2,0,2
292,Jim Mulcahey,39289507,Mick Laughlin,2,0,2
292,Jim Mulcahey,410854609,Dave Lowe,2,0,2
292,Jim Mulcahey,573567936,Steve Marriott,2,1,1
294,Bob Tullett,392533233,Jack Wright,2,1,1
294,Bob Tullett,641692362,Bob Taylor,2,1,1
294,Bob Tullett,713064363,John Trory,2,2,0
295,Graham Still,225850882,John McLellan,2,2,0
295,Graham Still,670256222,Connor Anderson,2,0,2
297,S. Grogan,878576746,Jon Hall,2,1,1
300,Graham Smart,225850882,John McLellan,2,0,2
300,Graham Smart,412256116,Andy Sutton,2,0,2
300,Graham Smart,574248035,Tony Mulhern,2,0,2
300,Graham Smart,901024459,Paul Charman,2,1,1
300,Graham Smart,954080507,Sam Corsby,2,0,2
301,Terry Grant,319,John Lojo,2,0,2
301,Terry Grant,26970170,Kai Michael,2,1,1
301,Terry Grant,364867274,Dave Lucking,2,0,2
301,Terry Grant,436708540,Bob Henley,2,0,2
303,Graham Williard,26970170,Kai Michael,2,1,1
303,Graham Williard,225850882,John McLellan,2,2,0
303,Graham Williard,436708540,Bob Henley,2,1,1
307,Alister Morrison,16253983,Tony Simmonds,2,1,1
307,Alister Morrison,144776055,Brian Wilkes,2,0,2
307,Alister Morrison,172899919,Derek Dale,2,2,0
307,Alister Morrison,733453947,Phil Canham,2,2,0
309,M. Humphries,316,Paul Redgate,2,0,2
309,M. Humphries,833156731,Jez Saunders,2,2,0
309,M. Humphries,858283721,Dave Dunstall,2,0,2
315,Peter Stevens,321,Mick Ingram,2,2,0
315,Peter Stevens,395,Herby Burchell,2,2,0
315,Peter Stevens,110039677,Mick Miller,2,2,0
315,Peter Stevens,266591683,Chris Roche,2,1,1
315,Peter Stevens,364867274,Dave Lucking,2,1,1
315,Peter Stevens,529382351,Greg Foat,2,1,1
315,Peter Stevens,809647573,John Taylor,2,2,0
315,Peter Stevens,889234854,Paul Smith,2,2,0
316,Paul Redgate,386,Sam Hains,2,2,0
316,Paul Redgate,390,Luke Cann,2,2,0
316,Paul Redgate,447,Barry Riddles,2,2,0
316,Paul Redgate,76011459,Kane Harman,2,1,1
316,Paul Redgate,266477517,Tony Baxter,2,0,2
316,Paul Redgate,293577764,Dave Crosskey,2,1,1
316,Paul Redgate,394906196,Mick Mabbitt,2,0,2
316,Paul Redgate,415524562,Dave King,2,0,2
316,Paul Redgate,495939788,Tyrone Davis,2,2,0
316,Paul Redgate,688252012,Sean Cooper,2,1,1
316,Paul Redgate,746406369,Loz O'Keefe,2,0,2
316,Paul Redgate,815023707,David Senior,2,1,1
316,Paul Redgate,936624299,Peter Gallant,2,1,1
316,Paul Redgate,966905561,Tony Dade,2,2,0
317,Austin Blackman,666735933,Mike Collier,2,0,2
318,Eddie Tuck,978156264,Bob Paine,2,0,2
319,John Lojo,3508579,John Murray,2,1,1
319,John Lojo,225850882,John McLellan,2,0,2
319,John Lojo,423038309,Ian Fennell,2,1,1
319,John Lojo,506320151,Frank Taylor,2,1,1
319,John Lojo,574248035,Tony Mulhern,2,1,1
319,John Lojo,598846718,Ben Sorrell,2,0,2
319,John Lojo,733453947,Phil Canham,2,0,2
319,John Lojo,752709358,Chris Mason,2,1,1
319,John Lojo,878576746,Jon Hall,2,1,1
319,John Lojo,974385564,Danny Booker,2,1,1
321,Mick Ingram,110039677,Mick Miller,2,1,1
321,Mick Ingram,411473516,Ray Canham,2,1,1
321,Mick Ingram,412256116,Andy Sutton,2,0,2
321,Mick Ingram,436708540,Bob Henley,2,0,2
321,Mick Ingram,506320151,Frank Taylor,2,0,2
321,Mick Ingram,574248035,Tony Mulhern,2,0,2
321,Mick Ingram,721321839,Matt Peake,2,0,2
321,Mick Ingram,732321233,Nathan Brooks,2,0,2
321,Mick Ingram,809647573,John Taylor,2,0,2
321,Mick Ingram,901024459,Paul Charman,2,0,2
326,Stefan Chandler,11133032,Simon Dent,2,0,2
326,Stefan Chandler,345558874,Zack Richardson,2,1,1
326,Stefan Chandler,515186402,Ben Evans,2,0,2
326,Stefan Chandler,666735933,Mike Collier,2,0,2
327,Harold Franks,384,Bryan Beck,2,0,2
327,Harold Franks,32061370,Toby Prince-Iles,2,0,2
327,Harold Franks,498330760,Mo Collins,2,1,1
336,L. Fulton,412256116,Andy Sutton,2,1,1
336,L. Fulton,574248035,Tony Mulhern,2,2,0
337,Adam Williams,732321233,Nathan Brooks,2,2,0
337,Adam Williams,845537273,Dave Gridley,2,0,2
337,Adam Williams,954080507,Sam Corsby,2,1,1
350,M. Hudson,307140835,Tony Strange,2,0,2
356,Scott Harris,160950731,Locky McCurdy,2,1,1
356,Scott Harris,598552542,John Colgan,2,0,2
356,Scott Harris,822983250,Alasdair Pratt,2,0,2
362,Gary Bottomly,810143915,Ben Welfare,2,2,0
365,Dan Buckwell,60575249,Ash Thurmer,2,2,0
365,Dan Buckwell,112887737,Pip Akehurst,2,1,1
365,Dan Buckwell,323907964,Russ Hughes,2,0,2
365,Dan Buckwell,617751649,Lee Simpson,2,0,2
365,Dan Buckwell,748064029,Paul Hughes,2,2,0
365,Dan Buckwell,752709358,Chris Mason,2,0,2
365,Dan Buckwell,963958265,Rodney Moogan,2,2,0
367,Chris Dolding,394,Alan Burchell,2,2,0
367,Chris Dolding,231445676,Tony Paice,2,1,1
371,Laurence Park,16253983,Tony Simmonds,2,0,2
371,Laurence Park,123792666,Jamie Thomas,2,0,2
371,Laurence Park,349269645,Barry Thornton,2,1,1
371,Laurence Park,392533233,Jack Wright,2,1,1
371,Laurence Park,417786644,Eddie Collins,2,2,0
371,Laurence Park,612265840,Paul Honeysett,2,2,0
371,Laurence Park,746406369,Loz O'Keefe,2,0,2
371,Laurence Park,884374645,Wayne Iddon,2,1,1
371,Laurence Park,954639632,Derek Budde,2,1,1
372,Jim Race,16253983,Tony Simmonds,2,0,2
374,Lloyd Saunders,378,Simon Howe,2,0,2
374,Lloyd Saunders,396,Richard Dale,2,1,1
374,Lloyd Saunders,386517733,Ady Halley,2,0,2
375,Paul Bailey,440,Gordon Carter,2,2,0
375,Paul Bailey,291816585,Jim Somers,2,2,0
375,Paul Bailey,392533233,Jack Wright,2,2,0
375,Paul Bailey,394906196,Mick Mabbitt,2,2,0
375,Paul Bailey,490170224,Jamie Matthews,2,2,0
375,Paul Bailey,713064363,John Trory,2,2,0
377,Gary Bradshaw,349269645,Barry Thornton,2,1,1
377,Gary Bradshaw,713064363,John Trory,2,2,0
377,Gary Bradshaw,845758589,Charlie James,2,1,1
378,Simon Howe,319057545,Brendan Lambe,2,2,0
378,Simon Howe,394906196,Mick Mabbitt,2,1,1
378,Simon Howe,948504778,Jon Fordham,2,2,0
384,Bryan Beck,399,Chris Upton,2,0,2
384,Bryan Beck,319057545,Brendan Lambe,2,0,2
384,Bryan Beck,417786644,Eddie Collins,2,1,1
384,Bryan Beck,430890681,Malcolm Cooper,2,0,2
384,Bryan Beck,501266206,David Fox,2,1,1
384,Bryan Beck,844676925,Kieran Williams,2,1,1
384,Bryan Beck,929636592,Danny Wilson,2,0,2
386,Sam Hains,28382047,Steve Harrington,2,1,1
386,Sam Hains,160950731,Locky McCurdy,2,0,2
386,Sam Hains,291816585,Jim Somers,2,2,0
386,Sam Hains,410854609,Dave Lowe,2,1,1
386,Sam Hains,966905561,Tony Dade,2,1,1
388,Jacob Stevenson,101751030,Simon Uddin,2,2,0
388,Jacob Stevenson,227209116,Peter Rawlinson,2,0,2
388,Jacob Stevenson,246154671,Alan Gunn,2,2,0
388,Jacob Stevenson,415524562,Dave King,2,1,1
388,Jacob Stevenson,746406369,Loz O'Keefe,2,2,0
390,Luke Cann,160950731,Locky McCurdy,2,1,1
390,Luke Cann,556095121,Tom Wright,2,0,2
392,Gareth Milburn,112887737,Pip Akehurst,2,2,0
392,Gareth Milburn,428102632,Anthony Flynn,2,1,1
392,Gareth Milburn,754250007,Freddie Blunden,2,0,2
393,Mark Purser,963958265,Rodney Moogan,2,0,2
394,Alan Burchell,231445676,Tony Paice,2,1,1
394,Alan Burchell,279543944,Peter Maurice,2,2,0
394,Alan Burchell,503528426,Larry Maloney,2,1,1
394,Alan Burchell,529382351,Greg Foat,2,2,0
394,Alan Burchell,561171273,Andy Norman,2,0,2
394,Alan Burchell,661923191,Steve Gardner,2,1,1
395,Herby Burchell,110039677,Mick Miller,2,0,2
395,Herby Burchell,503528426,Larry Maloney,2,1,1
395,Herby Burchell,608140548,David Gillingham,2,0,2
395,Herby Burchell,719124015,Tony Power,2,1,1
395,Herby Burchell,810143915,Ben Welfare,2,1,1
395,Herby Burchell,947620111,Neil Cutler,2,1,1
403,Joe Marcuson,943667183,John Stone,2,1,1
411,Phil Osbourne,746406369,Loz O'Keefe,2,0,2
414,Richard Kinnard,865803068,Dave Jones,2,2,0
431,Darren Jordan,60575249,Ash Thurmer,2,1,1
431,Darren Jordan,90176364,David Page,2,1,1
432,Vincent Elphick,752709358,Chris Mason,2,0,2
432,Vincent Elphick,963958265,Rodney Moogan,2,2,0
440,Gordon Carter,349269645,Barry Thornton,2,2,0
440,Gordon Carter,728690686,Rick Rothschild,2,0,2
440,Gordon Carter,746406369,Loz O'Keefe,2,0,2
440,Gordon Carter,936624299,Peter Gallant,2,1,1
442,Harvey Tuck,466,Ben Fielder,2,1,1
442,Harvey Tuck,516,Lee Fairclough,2,0,2
442,Harvey Tuck,293577764,Dave Crosskey,2,1,1
442,Harvey Tuck,363402934,Rod Phillippe,2,2,0
442,Harvey Tuck,426236650,Dave Parrott,2,2,0
442,Harvey Tuck,495939788,Tyrone Davis,2,2,0
442,Harvey Tuck,498330760,Mo Collins,2,1,1
442,Harvey Tuck,630748783,Darren Hills,2,2,0
442,Harvey Tuck,815023707,David Senior,2,1,1
445,Lachlan Monroe,510,Louie Crosskey,2,1,1
445,Lachlan Monroe,514,Tyler Barker,2,1,1
445,Lachlan Monroe,293577764,Dave Crosskey,2,1,1
445,Lachlan Monroe,294944526,Rob Teanby,2,1,1
445,Lachlan Monroe,409212679,Mark Chapman,2,0,2
445,Lachlan Monroe,567624732,Dave Brampton,2,1,1
445,Lachlan Monroe,815023707,David Senior,2,0,2
445,Lachlan Monroe,910809545,Blake Harman,2,1,1
445,Lachlan Monroe,978156264,Bob Paine,2,2,0
448,Adam Bradshaw,409212679,Mark Chapman,2,0,2
448,Adam Bradshaw,704007508,Alan Muir,2,1,1
448,Adam Bradshaw,736672590,Dean Perry,2,1,1
456,Daniel Marcantonio,479,Brian Welsh,2,1,1
456,Daniel Marcantonio,535728699,Fred Cooper,2,1,1
456,Daniel Marcantonio,736672590,Dean Perry,2,0,2
456,Daniel Marcantonio,867613624,Ian Dunhill,2,0,2
456,Daniel Marcantonio,922772801,Nick Buonanno,2,0,2
457,Mo Davids,521,Sam Pullen,2,0,2
457,Mo Davids,293577764,Dave Crosskey,2,0,2
457,Mo Davids,484159049,Tommy Wright,2,1,1
462,Stephen McCullough,670256222,Connor Anderson,2,1,1
466,Ben Fielder,266477517,Tony Baxter,2,1,1
466,Ben Fielder,294944526,Rob Teanby,2,1,1
466,Ben Fielder,978156264,Bob Paine,2,2,0
470,Jules Porreca,231445676,Tony Paice,2,2,0
470,Jules Porreca,717256135,Trevor Pickard,2,2,0
470,Jules Porreca,719124015,Tony Power,2,1,1
479,Brian Welsh,291816585,Jim Somers,2,2,0
479,Brian Welsh,360777082,Mark Bishop,2,1,1
479,Brian Welsh,498330760,Mo Collins,2,2,0
479,Brian Welsh,584652998,Harry Stone,2,2,0
479,Brian Welsh,736672590,Dean Perry,2,2,0
479,Brian Welsh,809984729,Neil Scutt,2,1,1
479,Brian Welsh,822983250,Alasdair Pratt,2,2,0
486,"Jim, Jr. Stevens",954080507,Sam Corsby,2,0,2
487,"Jim, Sr. Stevens",225850882,John McLellan,2,0,2
487,"Jim, Sr. Stevens",880982797,Ray Hunter,2,1,1
488,Roger Harrold,436708540,Bob Henley,2,1,1
488,Roger Harrold,444350794,Richard Freeman,2,2,0
488,Roger Harrold,809647573,John Taylor,2,2,0
492,Malcolm Beal,279543944,Peter Maurice,2,2,0
492,Malcolm Beal,429738563,Adam Buckingham,2,1,1
493,M. Holmes,301960429,Brian Collins,2,0,2
493,M. Holmes,490170224,Jamie Matthews,2,0,2
493,M. Holmes,669385277,Steve Towler,2,1,1
494,Simon Bates,246154671,Alan Gunn,2,2,0
494,Simon Bates,363402934,Rod Phillippe,2,1,1
494,Simon Bates,649240057,Mike Childs,2,2,0
494,Simon Bates,966905561,Tony Dade,2,0,2
495,Louie Nayna,815023707,David Senior,2,0,2
496,Lucas Flux,516,Lee Fairclough,2,1,1
496,Lucas Flux,401846353,Frank McHugh,2,0,2
497,Ben Melmoth,943667183,John Stone,2,1,1
502,Thomas Reilly,833156731,Jez Saunders,2,2,0
502,Thomas Reilly,962678119,John Worth,2,2,0
504,Aaron Immerson,174147986,Lee Cliff,2,2,0
504,Aaron Immerson,833156731,Jez Saunders,2,1,1
510,Louie Crosskey,266477517,Tony Baxter,2,1,1
510,Louie Crosskey,649240057,Mike Childs,2,0,2
511,Steve Pickard,815023707,David Senior,2,2,0
514,Tyler Barker,76011459,Kane Harman,2,0,2
514,Tyler Barker,401846353,Frank McHugh,2,1,1
514,Tyler Barker,649240057,Mike Childs,2,0,2
515,Simon Mackenzie,484159049,Tommy Wright,2,0,2
515,Simon Mackenzie,820231590,Alan Rook,2,0,2
515,Simon Mackenzie,943667183,John Stone,2,0,2
516,Lee Fairclough,978156264,Bob Paine,2,1,1
518,Barry Thompson,521,Sam Pullen,2,0,2
518,Barry Thompson,815023707,David Senior,2,1,1
521,Sam Pullen,76011459,Kane Harman,2,1,1
521,Sam Pullen,491435492,Simon Price,2,1,1
521,Sam Pullen,704007508,Alan Muir,2,1,1
523,Mark Collins,867613624,Ian Dunhill,2,2,0
533,Trevor Vine,484159049,Tommy Wright,2,0,2
1251038,Ben Clift,39289507,Mick Laughlin,2,0,2
1251038,Ben Clift,306438070,Martin Stocker,2,0,2
3508579,John Murray,704007508,Alan Muir,2,0,2
3508579,John Murray,733453947,Phil Canham,2,0,2
3508579,John Murray,845537273,Dave Gridley,2,0,2
5820499,Paul Bartlett,34787509,Dave McCarthy,2,0,2
5820499,Paul Bartlett,60575249,Ash Thurmer,2,1,1
5820499,Paul Bartlett,96103077,Paul Norris,2,0,2
5820499,Paul Bartlett,133207947,Jake Richardson,2,0,2
5820499,Paul Bartlett,345558874,Zack Richardson,2,0,2
5820499,Paul Bartlett,426009127,Bav Patel,2,0,2
5820499,Paul Bartlett,463709832,Danny Wong,2,1,1
5820499,Paul Bartlett,764177688,Barry Martin,2,1,1
5820499,Paul Bartlett,766684900,John Gillard,2,0,2
5820499,Paul Bartlett,837429850,Paul Beecham,2,0,2
5820499,Paul Bartlett,876526526,Ash Bull,2,1,1
5820499,Paul Bartlett,963958265,Rodney Moogan,2,0,2
11133032,Simon Dent,26970170,Kai Michael,2,1,1
11133032,Simon Dent,133207947,Jake Richardson,2,2,0
11133032,Simon Dent,356397577,David Morgan,2,2,0
11133032,Simon Dent,428102632,Anthony Flynn,2,2,0
11133032,Simon Dent,444639447,Andy Wong,2,2,0
11133032,Simon Dent,515186402,Ben Evans,2,2,0
11133032,Simon Dent,619390728,Steve Stylianou,2,0,2
11133032,Simon Dent,748064029,Paul Hughes,2,2,0
11133032,Simon Dent,764177688,Barry Martin,2,2,0
11133032,Simon Dent,797962517,Dave Lewis,2,2,0
11133032,Simon Dent,927588200,Tokki Yamaguchi,2,2,0
16253983,Tony Simmonds,112887737,Pip Akehurst,2,2,0
16253983,Tony Simmonds,118679261,Mick Lott,2,1,1
16253983,Tony Simmonds,223983583,Carl Wentworth,2,2,0
16253983,Tony Simmonds,231975313,Danny English,2,1,1
16253983,Tony Simmonds,351143642,Michael Palmer,2,2,0
16253983,Tony Simmonds,426009127,Bav Patel,2,1,1
16253983,Tony Simmonds,463709832,Danny Wong,2,2,0
16253983,Tony Simmonds,490170224,Jamie Matthews,2,2,0
16253983,Tony Simmonds,546362444,Anthony Trory,2,2,0
16253983,Tony Simmonds,598846718,Ben Sorrell,2,2,0
16253983,Tony Simmonds,676753614,Don James,2,2,0
16253983,Tony Simmonds,721321839,Matt Peake,2,1,1
16253983,Tony Simmonds,726498878,Grigory Yashkov,2,1,1
16253983,Tony Simmonds,734416600,DON PENALVER,2,1,1
16253983,Tony Simmonds,822983250,Alasdair Pratt,2,2,0
16253983,Tony Simmonds,948504778,Jon Fordham,2,1,1
16253983,Tony Simmonds,949603489,Pete Bennett,2,1,1
16253983,Tony Simmonds,954639632,Derek Budde,2,2,0
16253983,Tony Simmonds,963206772,Dean Moore,2,2,0
26970170,Kai Michael,60575249,Ash Thurmer,2,2,0
26970170,Kai Michael,133207947,Jake Richardson,2,1,1
26970170,Kai Michael,323907964,Russ Hughes,2,0,2
26970170,Kai Michael,341869673,Nigel Stilwell,2,0,2
26970170,Kai Michael,490170224,Jamie Matthews,2,2,0
26970170,Kai Michael,503528426,Larry Maloney,2,2,0
26970170,Kai Michael,574248035,Tony Mulhern,2,1,1
26970170,Kai Michael,608140548,David Gillingham,2,0,2
26970170,Kai Michael,662568995,Rob Wykes,2,0,2
26970170,Kai Michael,717256135,Trevor Pickard,2,0,2
26970170,Kai Michael,724342701,Nigel Lilley,2,1,1
26970170,Kai Michael,752709358,Chris Mason,2,0,2
26970170,Kai Michael,766684900,John Gillard,2,0,2
26970170,Kai Michael,794630189,Mark Coles,2,0,2
26970170,Kai Michael,831214643,Tony Shipley,2,1,1
26970170,Kai Michael,878576746,Jon Hall,2,0,2
27255501,Tom Lane,35191252,Nigel Hayward,2,1,1
27255501,Tom Lane,120138229,Adam Butler,2,0,2
27255501,Tom Lane,146404254,Randall Griffiths,2,0,2
27255501,Tom Lane,293122482,Stuart Maplesden,2,0,2
27255501,Tom Lane,394906196,Mick Mabbitt,2,1,1
27255501,Tom Lane,411473516,Ray Canham,2,1,1
27255501,Tom Lane,598846718,Ben Sorrell,2,0,2
27255501,Tom Lane,612265840,Paul Honeysett,2,1,1
27255501,Tom Lane,613893140,Matt Warner,2,1,1
27255501,Tom Lane,623613383,Chris Marsh,2,0,2
27255501,Tom Lane,669385277,Steve Towler,2,2,0
27255501,Tom Lane,670870044,David Flanagan,2,0,2
27255501,Tom Lane,688252012,Sean Cooper,2,0,2
27255501,Tom Lane,688778183,Dean Paice,2,0,2
27255501,Tom Lane,733453947,Phil Canham,2,0,2
27255501,Tom Lane,835713833,Olly Stewart,2,0,2
27255501,Tom Lane,852327692,Andy Fletcher,2,1,1
27255501,Tom Lane,866506631,Mark Smith,2,1,1
27255501,Tom Lane,899206834,Jez Downs,2,0,2
27255501,Tom Lane,901024459,Paul Charman,2,2,0
27255501,Tom Lane,910809545,Blake Harman,2,2,0
27255501,Tom Lane,963206772,Dean Moore,2,0,2
28382047,Steve Harrington,34787509,Dave McCarthy,2,0,2
28382047,Steve Harrington,144776055,Brian Wilkes,2,0,2
28382047,Steve Harrington,349269645,Barry Thornton,2,2,0
28382047,Steve Harrington,430890681,Malcolm Cooper,2,1,1
28382047,Steve Harrington,567624732,Dave Brampton,2,0,2
28382047,Steve Harrington,612265840,Paul Honeysett,2,2,0
28382047,Steve Harrington,654650203,Alan O'Sullivan,2,0,2
28382047,Steve Harrington,704007508,Alan Muir,2,0,2
28382047,Steve Harrington,809647573,John Taylor,2,1,1
28382047,Steve Harrington,884374645,Wayne Iddon,2,1,1
28382047,Steve Harrington,970786910,Kevin Sorrell,2,0,2
32061370,Toby Prince-Iles,35191252,Nigel Hayward,2,1,1
32061370,Toby Prince-Iles,56252722,Dave Pither,2,1,1
32061370,Toby Prince-Iles,83590771,Nick Brayne,2,2,0
32061370,Toby Prince-Iles,101751030,Simon Uddin,2,0,2
32061370,Toby Prince-Iles,123792666,Jamie Thomas,2,0,2
32061370,Toby Prince-Iles,231445676,Tony Paice,2,1,1
32061370,Toby Prince-Iles,246154671,Alan Gunn,2,1,1
32061370,Toby Prince-Iles,291816585,Jim Somers,2,1,1
32061370,Toby Prince-Iles,360777082,Mark Bishop,2,0,2
32061370,Toby Prince-Iles,402257815,Jim Cumming,2,2,0
32061370,Toby Prince-Iles,409212679,Mark Chapman,2,0,2
32061370,Toby Prince-Iles,567316488,Lee Millyard,2,0,2
32061370,Toby Prince-Iles,567624732,Dave Brampton,2,0,2
32061370,Toby Prince-Iles,584652998,Harry Stone,2,2,0
32061370,Toby Prince-Iles,612265840,Paul Honeysett,2,1,1
32061370,Toby Prince-Iles,732415457,Barry Hall,2,1,1
32061370,Toby Prince-Iles,733453947,Phil Canham,2,1,1
32061370,Toby Prince-Iles,737709582,Tony Browne,2,1,1
32061370,Toby Prince-Iles,740135236,Craig Marchant,2,1,1
32061370,Toby Prince-Iles,820231590,Alan Rook,2,0,2
32061370,Toby Prince-Iles,833156731,Jez Saunders,2,2,0
32061370,Toby Prince-Iles,845758589,Charlie James,2,2,0
32061370,Toby Prince-Iles,879771694,Darren Parker,2,2,0
32061370,Toby Prince-Iles,884374645,Wayne Iddon,2,1,1
32061370,Toby Prince-Iles,915035871,Kevin Graysmark,2,1,1
32061370,Toby Prince-Iles,978156264,Bob Paine,2,0,2
34787509,Dave McCarthy,59858690,James Constable,2,0,2
34787509,Dave McCarthy,229719541,Scott Manning,2,2,0
34787509,Dave McCarthy,231975313,Danny English,2,1,1
34787509,Dave McCarthy,323907964,Russ Hughes,2,1,1
34787509,Dave McCarthy,356397577,David Morgan,2,0,2
34787509,Dave McCarthy,417786644,Eddie Collins,2,2,0
34787509,Dave McCarthy,506581042,Glen Dartnell,2,2,0
34787509,Dave McCarthy,680442672,Scott Lawson,2,0,2
34787509,Dave McCarthy,797962517,Dave Lewis,2,0,2
34787509,Dave McCarthy,825399596,Pat Adams,2,1,1
34787509,Dave McCarthy,865803068,Dave Jones,2,1,1
35191252,Nigel Hayward,160950731,Locky McCurdy,2,0,2
35191252,Nigel Hayward,567316488,Lee Millyard,2,0,2
35191252,Nigel Hayward,688252012,Sean Cooper,2,0,2
35191252,Nigel Hayward,704007508,Alan Muir,2,0,2
35191252,Nigel Hayward,733453947,Phil Canham,2,1,1
35191252,Nigel Hayward,867613624,Ian Dunhill,2,1,1
35191252,Nigel Hayward,873916947,Geoff Akehurst,2,1,1
39289507,Mick Laughlin,231445676,Tony Paice,2,0,2
39289507,Mick Laughlin,288891270,Lewis Copping,2,0,2
39289507,Mick Laughlin,349269645,Barry Thornton,2,2,0
39289507,Mick Laughlin,402257815,Jim Cumming,2,2,0
39289507,Mick Laughlin,415524562,Dave King,2,1,1
39289507,Mick Laughlin,430890681,Malcolm Cooper,2,2,0
39289507,Mick Laughlin,495939788,Tyrone Davis,2,2,0
39289507,Mick Laughlin,567316488,Lee Millyard,2,0,2
39289507,Mick Laughlin,573567936,Steve Marriott,2,1,1
39289507,Mick Laughlin,657320021,Brett Strevens,2,2,0
39289507,Mick Laughlin,688252012,Sean Cooper,2,2,0
39289507,Mick Laughlin,736672590,Dean Perry,2,0,2
39289507,Mick Laughlin,773216781,Sean Payne,2,0,2
39289507,Mick Laughlin,844676925,Kieran Williams,2,2,0
39289507,Mick Laughlin,970786910,Kevin Sorrell,2,1,1
39289507,Mick Laughlin,978156264,Bob Paine,2,2,0
41098823,Mikey Booker,117247901,Dave Verey,2,1,1
41098823,Mikey Booker,118679261,Mick Lott,2,2,0
41098823,Mikey Booker,120138229,Adam Butler,2,2,0
41098823,Mikey Booker,436708540,Bob Henley,2,2,0
41098823,Mikey Booker,597923939,David Lovegrove,2,0,2
41098823,Mikey Booker,608140548,David Gillingham,2,0,2
41098823,Mikey Booker,670034050,John Muzio,2,2,0
41098823,Mikey Booker,688252012,Sean Cooper,2,2,0
41098823,Mikey Booker,703030938,Ollie Thurmer,2,1,1
41098823,Mikey Booker,788605510,Mark Rose,2,2,0
41098823,Mikey Booker,954080507,Sam Corsby,2,0,2
41098823,Mikey Booker,991443521,Adam Griffiths,2,0,2
41461520,Luke Pooley,291198629,Tony Burt,2,0,2
41461520,Luke Pooley,293577764,Dave Crosskey,2,1,1
41461520,Luke Pooley,351143642,Michael Palmer,2,0,2
41461520,Luke Pooley,426236650,Dave Parrott,2,1,1
41461520,Luke Pooley,501266206,David Fox,2,0,2
41461520,Luke Pooley,612265840,Paul Honeysett,2,1,1
41461520,Luke Pooley,688778183,Dean Paice,2,0,2
41461520,Luke Pooley,804381932,Ryan Harman,2,1,1
41461520,Luke Pooley,831214643,Tony Shipley,2,0,2
41461520,Luke Pooley,845758589,Charlie James,2,1,1
41461520,Luke Pooley,936624299,Peter Gallant,2,1,1
41461520,Luke Pooley,943667183,John Stone,2,0,2
41461520,Luke Pooley,971308746,Clive Harman,2,0,2
45305697,John Barratt,411473516,Ray Canham,2,1,1
56252722,Dave Pither,319057545,Brendan Lambe,2,2,0
56252722,Dave Pither,392533233,Jack Wright,2,1,1
56252722,Dave Pither,394906196,Mick Mabbitt,2,1,1
56252722,Dave Pither,417786644,Eddie Collins,2,0,2
56252722,Dave Pither,498330760,Mo Collins,2,1,1
56252722,Dave Pither,523395206,Jamie Lashmar,2,0,2
56252722,Dave Pither,737709582,Tony Browne,2,0,2
56252722,Dave Pither,800114325,Roger Whiteley,2,0,2
56252722,Dave Pither,809984729,Neil Scutt,2,1,1
56252722,Dave Pither,922772801,Nick Buonanno,2,1,1
59858690,James Constable,133207947,Jake Richardson,2,1,1
59858690,James Constable,384960657,Dave Lewney,2,2,0
59858690,James Constable,561171273,Andy Norman,2,2,0
59858690,James Constable,617751649,Lee Simpson,2,2,0
59858690,James Constable,619390728,Steve Stylianou,2,1,1
59858690,James Constable,732321233,Nathan Brooks,2,2,0
59858690,James Constable,797962517,Dave Lewis,2,2,0
59858690,James Constable,837429850,Paul Beecham,2,1,1
59858690,James Constable,850059806,Heng Wong,2,1,1
59858690,James Constable,948504778,Jon Fordham,2,0,2
59858690,James Constable,957784480,Harry Banks,2,2,0
60309233,Dan Harley,436708540,Bob Henley,2,1,1
60309233,Dan Harley,573567936,Steve Marriott,2,1,1
60309233,Dan Harley,943667183,John Stone,2,2,0
60575249,Ash Thurmer,96103077,Paul Norris,2,1,1
60575249,Ash Thurmer,96354463,Rob Pickard,2,2,0
60575249,Ash Thurmer,144293731,Simon Parry,2,1,1
60575249,Ash Thurmer,192463126,Gerry Lindsey,2,2,0
60575249,Ash Thurmer,279543944,Peter Maurice,2,2,0
60575249,Ash Thurmer,323907964,Russ Hughes,2,0,2
60575249,Ash Thurmer,480772114,Kevin Ward,2,0,2
60575249,Ash Thurmer,523395206,Jamie Lashmar,2,1,1
60575249,Ash Thurmer,595079459,Ben Fordham,2,0,2
60575249,Ash Thurmer,927588200,Tokki Yamaguchi,2,0,2
69745818,Ian Bowles,231445676,Tony Paice,2,0,2
69745818,Ian Bowles,288891270,Lewis Copping,2,0,2
69745818,Ian Bowles,567624732,Dave Brampton,2,0,2
69745818,Ian Bowles,579164381,Danny Cattell,2,1,1
69745818,Ian Bowles,613893140,Matt Warner,2,0,2
69745818,Ian Bowles,713064363,John Trory,2,0,2
69745818,Ian Bowles,733453947,Phil Canham,2,1,1
69745818,Ian Bowles,852327692,Andy Fletcher,2,1,1
69745818,Ian Bowles,943667183,John Stone,2,0,2
70159035,Peter Rea,266477517,Tony Baxter,2,2,0
70159035,Peter Rea,287057630,Darren Hearn,2,2,0
70159035,Peter Rea,291198629,Tony Burt,2,2,0
70159035,Peter Rea,301960429,Brian Collins,2,1,1
70159035,Peter Rea,417786644,Eddie Collins,2,2,0
70159035,Peter Rea,535728699,Fred Cooper,2,2,0
70159035,Peter Rea,579164381,Danny Cattell,2,0,2
70159035,Peter Rea,598117191,Jerome Fowler,2,2,0
70159035,Peter Rea,670870044,David Flanagan,2,1,1
70159035,Peter Rea,733453947,Phil Canham,2,1,1
70159035,Peter Rea,833156731,Jez Saunders,2,2,0
70159035,Peter Rea,929636592,Danny Wilson,2,2,0
70159035,Peter Rea,943667183,John Stone,2,1,1
70159035,Peter Rea,968651401,Ryan Grover,2,2,0
76011459,Kane Harman,118679261,Mick Lott,2,2,0
76011459,Kane Harman,174147986,Lee Cliff,2,2,0
76011459,Kane Harman,183400466,David Wright,2,2,0
76011459,Kane Harman,204951513,Mike Holding,2,1,1
76011459,Kane Harman,258549102,Tony Lee,2,1,1
76011459,Kane Harman,294944526,Rob Teanby,2,1,1
76011459,Kane Harman,484159049,Tommy Wright,2,1,1
76011459,Kane Harman,529382351,Greg Foat,2,1,1
76011459,Kane Harman,580088564,Tom Trafford,2,2,0
76011459,Kane Harman,584652998,Harry Stone,2,1,1
76011459,Kane Harman,608140548,David Gillingham,2,0,2
76011459,Kane Harman,649078882,Richard Barrett,2,0,2
76011459,Kane Harman,670870044,David Flanagan,2,1,1
76011459,Kane Harman,688252012,Sean Cooper,2,1,1
76011459,Kane Harman,721321839,Matt Peake,2,2,0
76011459,Kane Harman,724342701,Nigel Lilley,2,2,0
76011459,Kane Harman,845758589,Charlie James,2,2,0
76011459,Kane Harman,901024459,Paul Charman,2,2,0
76011459,Kane Harman,963206772,Dean Moore,2,1,1
76011459,Kane Harman,970786910,Kevin Sorrell,2,1,1
83590771,Nick Brayne,160950731,Locky McCurdy,2,2,0
83590771,Nick Brayne,225850882,John McLellan,2,0,2
83590771,Nick Brayne,402257815,Jim Cumming,2,2,0
83590771,Nick Brayne,498330760,Mo Collins,2,2,0
83590771,Nick Brayne,670034050,John Muzio,2,1,1
83590771,Nick Brayne,688252012,Sean Cooper,2,0,2
83590771,Nick Brayne,788605510,Mark Rose,2,2,0
90176364,David Page,307140835,Tony Strange,2,1,1
90176364,David Page,323907964,Russ Hughes,2,0,2
90176364,David Page,617751649,Lee Simpson,2,0,2
90176364,David Page,666735933,Mike Collier,2,0,2
90176364,David Page,754250007,Freddie Blunden,2,0,2
90176364,David Page,836895047,Ian McKay,2,2,0
96103077,Paul Norris,141540226,Pete Hazell,2,2,0
96103077,Paul Norris,147556923,Hong Ming Lee,2,2,0
96103077,Paul Norris,278731588,Lester Grice,2,1,1
96103077,Paul Norris,646410961,Paul Scorer,2,0,2
96103077,Paul Norris,662568995,Rob Wykes,2,2,0
96103077,Paul Norris,666735933,Mike Collier,2,1,1
96103077,Paul Norris,717256135,Trevor Pickard,2,2,0
96103077,Paul Norris,766684900,John Gillard,2,1,1
96103077,Paul Norris,802242736,Steve Hughes,2,2,0
96103077,Paul Norris,837429850,Paul Beecham,2,2,0
96103077,Paul Norris,947143243,Chris Davis,2,2,0
96354463,Rob Pickard,144293731,Simon Parry,2,1,1
96354463,Rob Pickard,384960657,Dave Lewney,2,1,1
96354463,Rob Pickard,617751649,Lee Simpson,2,2,0
96354463,Rob Pickard,619390728,Steve Stylianou,2,1,1
96354463,Rob Pickard,773216781,Sean Payne,2,2,0
96354463,Rob Pickard,825399596,Pat Adams,2,1,1
101751030,Simon Uddin,160950731,Locky McCurdy,2,1,1
101751030,Simon Uddin,349269645,Barry Thornton,2,1,1
101751030,Simon Uddin,417786644,Eddie Collins,2,2,0
101751030,Simon Uddin,535728699,Fred Cooper,2,1,1
101751030,Simon Uddin,556095121,Tom Wright,2,0,2
101751030,Simon Uddin,936624299,Peter Gallant,2,1,1
110039677,Mick Miller,202090738,Alan Head,2,1,1
110039677,Mick Miller,227209116,Peter Rawlinson,2,1,1
110039677,Mick Miller,291198629,Tony Burt,2,2,0
110039677,Mick Miller,351143642,Michael Palmer,2,1,1
110039677,Mick Miller,480154054,Jim Dunstall,2,2,0
110039677,Mick Miller,506320151,Frank Taylor,2,1,1
110039677,Mick Miller,688778183,Dean Paice,2,0,2
110039677,Mick Miller,836895047,Ian McKay,2,1,1
110039677,Mick Miller,858283721,Dave Dunstall,2,1,1
110039677,Mick Miller,911104566,Steve Linton,2,1,1
110039677,Mick Miller,954080507,Sam Corsby,2,1,1
112887737,Pip Akehurst,114184042,Ian Smith,2,1,1
112887737,Pip Akehurst,282510619,Harry Green,2,2,0
112887737,Pip Akehurst,436708540,Bob Henley,2,2,0
112887737,Pip Akehurst,444639447,Andy Wong,2,1,1
112887737,Pip Akehurst,463709832,Danny Wong,2,1,1
112887737,Pip Akehurst,484159049,Tommy Wright,2,1,1
112887737,Pip Akehurst,529382351,Greg Foat,2,2,0
112887737,Pip Akehurst,619390728,Steve Stylianou,2,0,2
112887737,Pip Akehurst,649078882,Richard Barrett,2,2,0
112887737,Pip Akehurst,666735933,Mike Collier,2,0,2
112887737,Pip Akehurst,680442672,Scott Lawson,2,0,2
112887737,Pip Akehurst,800114325,Roger Whiteley,2,0,2
112887737,Pip Akehurst,809568302,Mark Johnson,2,1,1
112887737,Pip Akehurst,837429850,Paul Beecham,2,1,1
112887737,Pip Akehurst,866506631,Mark Smith,2,2,0
112887737,Pip Akehurst,880982797,Ray Hunter,2,2,0
112887737,Pip Akehurst,899206834,Jez Downs,2,2,0
112887737,Pip Akehurst,949603489,Pete Bennett,2,2,0
112887737,Pip Akehurst,970786910,Kevin Sorrell,2,2,0
112887737,Pip Akehurst,971308746,Clive Harman,2,2,0
112887737,Pip Akehurst,974385564,Danny Booker,2,1,1
114007838,John Paine,417786644,Eddie Collins,2,2,0
114007838,John Paine,529382351,Greg Foat,2,1,1
114007838,John Paine,733453947,Phil Canham,2,1,1
114184042,Ian Smith,204951513,Mike Holding,2,1,1
114184042,Ian Smith,327948141,Ross Etheridge,2,1,1
114184042,Ian Smith,351143642,Michael Palmer,2,2,0
114184042,Ian Smith,409212679,Mark Chapman,2,1,1
114184042,Ian Smith,436708540,Bob Henley,2,1,1
114184042,Ian Smith,463709832,Danny Wong,2,1,1
114184042,Ian Smith,490170224,Jamie Matthews,2,0,2
114184042,Ian Smith,529382351,Greg Foat,2,1,1
114184042,Ian Smith,579164381,Danny Cattell,2,0,2
114184042,Ian Smith,598846718,Ben Sorrell,2,1,1
114184042,Ian Smith,608140548,David Gillingham,2,0,2
114184042,Ian Smith,669385277,Steve Towler,2,2,0
114184042,Ian Smith,670034050,John Muzio,2,1,1
114184042,Ian Smith,703030938,Ollie Thurmer,2,1,1
114184042,Ian Smith,728690686,Rick Rothschild,2,0,2
114184042,Ian Smith,736672590,Dean Perry,2,1,1
114184042,Ian Smith,747966869,Richard Morgan,2,2,0
114184042,Ian Smith,788605510,Mark Rose,2,0,2
114184042,Ian Smith,822983250,Alasdair Pratt,2,1,1
114184042,Ian Smith,825399596,Pat Adams,2,0,2
114184042,Ian Smith,837429850,Paul Beecham,2,1,1
114184042,Ian Smith,884365412,Dave Haslam,2,0,2
114184042,Ian Smith,899206834,Jez Downs,2,2,0
114184042,Ian Smith,974385564,Danny Booker,2,0,2
114319292,Oliver Gorrod,287057630,Darren Hearn,2,2,0
114319292,Oliver Gorrod,501266206,David Fox,2,1,1
114319292,Oliver Gorrod,567316488,Lee Millyard,2,1,1
114319292,Oliver Gorrod,688252012,Sean Cooper,2,2,0
114319292,Oliver Gorrod,807603289,Kevin Gardner,2,1,1
114319292,Oliver Gorrod,809647573,John Taylor,2,0,2
114319292,Oliver Gorrod,835713833,Olly Stewart,2,0,2
114319292,Oliver Gorrod,929636592,Danny Wilson,2,2,0
114319292,Oliver Gorrod,949603489,Pete Bennett,2,1,1
114319292,Oliver Gorrod,970786910,Kevin Sorrell,2,0,2
114319292,Oliver Gorrod,971308746,Clive Harman,2,1,1
117247901,Dave Verey,171346729,Des Heasman,2,2,0
117247901,Dave Verey,364867274,Dave Lucking,2,2,0
117247901,Dave Verey,436708540,Bob Henley,2,2,0
117247901,Dave Verey,805165161,Steve Owen,2,0,2
117247901,Dave Verey,848997254,Tom Parker,2,1,1
117247901,Dave Verey,884365412,Dave Haslam,2,1,1
117247901,Dave Verey,947620111,Neil Cutler,2,2,0
117247901,Dave Verey,963206772,Dean Moore,2,2,0
118679261,Mick Lott,174147986,Lee Cliff,2,1,1
118679261,Mick Lott,278731588,Lester Grice,2,1,1
118679261,Mick Lott,360777082,Mark Bishop,2,2,0
118679261,Mick Lott,463709832,Danny Wong,2,1,1
118679261,Mick Lott,623613383,Chris Marsh,2,1,1
118679261,Mick Lott,878576746,Jon Hall,2,0,2
118679261,Mick Lott,954080507,Sam Corsby,2,0,2
120138229,Adam Butler,124523642,Tom Hayes,2,1,1
120138229,Adam Butler,360777082,Mark Bishop,2,1,1
120138229,Adam Butler,455401154,Kai Ellis,2,1,1
120138229,Adam Butler,463709832,Danny Wong,2,2,0
120138229,Adam Butler,809984729,Neil Scutt,2,1,1
120138229,Adam Butler,878576746,Jon Hall,2,2,0
120138229,Adam Butler,970786910,Kevin Sorrell,2,2,0
123792666,Jamie Thomas,293577764,Dave Crosskey,2,2,0
123792666,Jamie Thomas,392533233,Jack Wright,2,2,0
123792666,Jamie Thomas,501266206,David Fox,2,1,1
123792666,Jamie Thomas,535728699,Fred Cooper,2,1,1
123792666,Jamie Thomas,809984729,Neil Scutt,2,1,1
123792666,Jamie Thomas,845758589,Charlie James,2,2,0
123792666,Jamie Thomas,856755662,David Marsh,2,2,0
124523642,Tom Hayes,174147986,Lee Cliff,2,2,0
124523642,Tom Hayes,225850882,John McLellan,2,0,2
124523642,Tom Hayes,326342962,Geoff Randall,2,0,2
124523642,Tom Hayes,360777082,Mark Bishop,2,1,1
124523642,Tom Hayes,386517733,Ady Halley,2,2,0
124523642,Tom Hayes,426009127,Bav Patel,2,0,2
124523642,Tom Hayes,436708540,Bob Henley,2,1,1
124523642,Tom Hayes,463709832,Danny Wong,2,1,1
124523642,Tom Hayes,480154054,Jim Dunstall,2,2,0
124523642,Tom Hayes,537640521,Ian Stoner,2,2,0
124523642,Tom Hayes,574248035,Tony Mulhern,2,1,1
124523642,Tom Hayes,654650203,Alan O'Sullivan,2,0,2
124523642,Tom Hayes,677110925,Jake Dunstall,2,2,0
124523642,Tom Hayes,680442672,Scott Lawson,2,1,1
124523642,Tom Hayes,719124015,Tony Power,2,1,1
124523642,Tom Hayes,734416600,DON PENALVER,2,1,1
124523642,Tom Hayes,805165161,Steve Owen,2,2,0
124523642,Tom Hayes,844676925,Kieran Williams,2,2,0
124523642,Tom Hayes,878576746,Jon Hall,2,2,0
133207947,Jake Richardson,141540226,Pete Hazell,2,1,1
133207947,Jake Richardson,144293731,Simon Parry,2,2,0
133207947,Jake Richardson,307140835,Tony Strange,2,0,2
133207947,Jake Richardson,384960657,Dave Lewney,2,1,1
133207947,Jake Richardson,490170224,Jamie Matthews,2,2,0
133207947,Jake Richardson,600385553,Darren Welfare,2,1,1
133207947,Jake Richardson,608140548,David Gillingham,2,1,1
133207947,Jake Richardson,629014363,Lee Shepherd,2,2,0
133207947,Jake Richardson,654650203,Alan O'Sullivan,2,2,0
133207947,Jake Richardson,688778183,Dean Paice,2,1,1
133207947,Jake Richardson,766684900,John Gillard,2,1,1
133207947,Jake Richardson,800114325,Roger Whiteley,2,2,0
133207947,Jake Richardson,810143915,Ben Welfare,2,1,1
133207947,Jake Richardson,825399596,Pat Adams,2,0,2
133207947,Jake Richardson,836895047,Ian McKay,2,0,2
133207947,Jake Richardson,876526526,Ash Bull,2,2,0
133207947,Jake Richardson,963958265,Rodney Moogan,2,2,0
141540226,Pete Hazell,464085958,Gerwyn Bowen,2,2,0
141540226,Pete Hazell,515186402,Ben Evans,2,1,1
141540226,Pete Hazell,600385553,Darren Welfare,2,2,0
141540226,Pete Hazell,957784480,Harry Banks,2,1,1
141540226,Pete Hazell,974385564,Danny Booker,2,1,1
144181207,Jack Yates,386517733,Ady Halley,2,0,2
144181207,Jack Yates,598117191,Jerome Fowler,2,0,2
144293731,Simon Parry,426009127,Bav Patel,2,1,1
144293731,Simon Parry,428102632,Anthony Flynn,2,0,2
144293731,Simon Parry,680442672,Scott Lawson,2,1,1
144293731,Simon Parry,748064029,Paul Hughes,2,0,2
144293731,Simon Parry,754250007,Freddie Blunden,2,1,1
144293731,Simon Parry,802242736,Steve Hughes,2,1,1
144293731,Simon Parry,963958265,Rodney Moogan,2,1,1
144776055,Brian Wilkes,171346729,Des Heasman,2,1,1
144776055,Brian Wilkes,172899919,Derek Dale,2,2,0
144776055,Brian Wilkes,174147986,Lee Cliff,2,1,1
144776055,Brian Wilkes,216787426,Jack Perrin,2,2,0
144776055,Brian Wilkes,229719541,Scott Manning,2,0,2
144776055,Brian Wilkes,293577764,Dave Crosskey,2,2,0
144776055,Brian Wilkes,392533233,Jack Wright,2,1,1
144776055,Brian Wilkes,417786644,Eddie Collins,2,2,0
144776055,Brian Wilkes,455401154,Kai Ellis,2,0,2
144776055,Brian Wilkes,529382351,Greg Foat,2,1,1
144776055,Brian Wilkes,573567936,Steve Marriott,2,0,2
144776055,Brian Wilkes,574248035,Tony Mulhern,2,0,2
144776055,Brian Wilkes,809647573,John Taylor,2,1,1
144776055,Brian Wilkes,820231590,Alan Rook,2,2,0
144776055,Brian Wilkes,839313888,Kevin Chrysanthou,2,2,0
144776055,Brian Wilkes,845758589,Charlie James,2,1,1
144776055,Brian Wilkes,889234854,Paul Smith,2,1,1
144776055,Brian Wilkes,899206834,Jez Downs,2,1,1
144776055,Brian Wilkes,953512654,Les Berry,2,1,1
144776055,Brian Wilkes,970786910,Kevin Sorrell,2,1,1
144776055,Brian Wilkes,971308746,Clive Harman,2,0,2
146404254,Randall Griffiths,423038309,Ian Fennell,2,0,2
146404254,Randall Griffiths,567316488,Lee Millyard,2,1,1
146404254,Randall Griffiths,732415457,Barry Hall,2,1,1
146404254,Randall Griffiths,963206772,Dean Moore,2,0,2
147556923,Hong Ming Lee,384960657,Dave Lewney,2,2,0
147556923,Hong Ming Lee,436708540,Bob Henley,2,1,1
147556923,Hong Ming Lee,617751649,Lee Simpson,2,0,2
147556923,Hong Ming Lee,837429850,Paul Beecham,2,2,0
152643729,Lew Heath,831214643,Tony Shipley,2,2,0
157282960,Vern Asbury,974385564,Danny Booker,2,1,1
160950731,Locky McCurdy,183400466,David Wright,2,0,2
160950731,Locky McCurdy,417786644,Eddie Collins,2,2,0
160950731,Locky McCurdy,503528426,Larry Maloney,2,1,1
160950731,Locky McCurdy,598552542,John Colgan,2,2,0
160950731,Locky McCurdy,598846718,Ben Sorrell,2,1,1
160950731,Locky McCurdy,649240057,Mike Childs,2,2,0
160950731,Locky McCurdy,661923191,Steve Gardner,2,0,2
160950731,Locky McCurdy,733453947,Phil Canham,2,0,2
160950731,Locky McCurdy,746406369,Loz O'Keefe,2,0,2
160950731,Locky McCurdy,820231590,Alan Rook,2,0,2
160950731,Locky McCurdy,822983250,Alasdair Pratt,2,0,2
160950731,Locky McCurdy,831214643,Tony Shipley,2,0,2
160950731,Locky McCurdy,835713833,Olly Stewart,2,0,2
160950731,Locky McCurdy,901024459,Paul Charman,2,0,2
163959771,Alex El-Deweiny,174147986,Lee Cliff,2,2,0
171346729,Des Heasman,172646809,Robin Powell,2,2,0
171346729,Des Heasman,207592931,(shorty) Gediminas Aleksandravicius,2,1,1
171346729,Des Heasman,223983583,Carl Wentworth,2,2,0
171346729,Des Heasman,231445676,Tony Paice,2,1,1
171346729,Des Heasman,319057545,Brendan Lambe,2,2,0
171346729,Des Heasman,402257815,Jim Cumming,2,2,0
171346729,Des Heasman,412256116,Andy Sutton,2,1,1
171346729,Des Heasman,423038309,Ian Fennell,2,0,2
171346729,Des Heasman,579164381,Danny Cattell,2,0,2
171346729,Des Heasman,613893140,Matt Warner,2,0,2
171346729,Des Heasman,670256222,Connor Anderson,2,0,2
171346729,Des Heasman,752709358,Chris Mason,2,1,1
171346729,Des Heasman,809647573,John Taylor,2,2,0
171346729,Des Heasman,884365412,Dave Haslam,2,0,2
171346729,Des Heasman,899206834,Jez Downs,2,0,2
171346729,Des Heasman,949603489,Pete Bennett,2,1,1
171346729,Des Heasman,953512654,Les Berry,2,0,2
171346729,Des Heasman,966905561,Tony Dade,2,2,0
171346729,Des Heasman,974385564,Danny Booker,2,0,2
172646809,Robin Powell,229719541,Scott Manning,2,0,2
172646809,Robin Powell,258549102,Tony Lee,2,1,1
172646809,Robin Powell,293122482,Stuart Maplesden,2,0,2
172646809,Robin Powell,294944526,Rob Teanby,2,1,1
172646809,Robin Powell,295120010,Andy Yarrow,2,1,1
172646809,Robin Powell,417786644,Eddie Collins,2,2,0
172646809,Robin Powell,444339215,Steve Richards,2,0,2
172646809,Robin Powell,501266206,David Fox,2,2,0
172646809,Robin Powell,529382351,Greg Foat,2,1,1
172646809,Robin Powell,579164381,Danny Cattell,2,0,2
172646809,Robin Powell,810143915,Ben Welfare,2,0,2
172646809,Robin Powell,843981340,Mark Glover,2,0,2
172646809,Robin Powell,901024459,Paul Charman,2,0,2
172899919,Derek Dale,537640521,Ian Stoner,2,0,2
172899919,Derek Dale,574248035,Tony Mulhern,2,1,1
174147986,Lee Cliff,225247539,Barry Knight,2,0,2
174147986,Lee Cliff,392533233,Jack Wright,2,2,0
174147986,Lee Cliff,567316488,Lee Millyard,2,1,1
174147986,Lee Cliff,669385277,Steve Towler,2,1,1
174147986,Lee Cliff,732415457,Barry Hall,2,1,1
174147986,Lee Cliff,805165161,Steve Owen,2,1,1
174147986,Lee Cliff,809647573,John Taylor,2,1,1
174147986,Lee Cliff,833156731,Jez Saunders,2,1,1
174147986,Lee Cliff,873916947,Geoff Akehurst,2,2,0
174147986,Lee Cliff,911104566,Steve Linton,2,2,0
174147986,Lee Cliff,929636592,Danny Wilson,2,1,1
174147986,Lee Cliff,954080507,Sam Corsby,2,2,0
183400466,David Wright,537640521,Ian Stoner,2,0,2
183400466,David Wright,613893140,Matt Warner,2,0,2
183400466,David Wright,837429850,Paul Beecham,2,0,2
192463126,Gerry Lindsey,231975313,Danny English,2,0,2
192463126,Gerry Lindsey,384960657,Dave Lewney,2,0,2
192463126,Gerry Lindsey,426009127,Bav Patel,2,0,2
192463126,Gerry Lindsey,797962517,Dave Lewis,2,0,2
202090738,Alan Head,231445676,Tony Paice,2,1,1
202090738,Alan Head,293122482,Stuart Maplesden,2,1,1
202090738,Alan Head,394906196,Mick Mabbitt,2,0,2
202090738,Alan Head,417786644,Eddie Collins,2,2,0
202090738,Alan Head,429738563,Adam Buckingham,2,1,1
204951513,Mike Holding,225247539,Barry Knight,2,1,1
204951513,Mike Holding,363402934,Rod Phillippe,2,2,0
204951513,Mike Holding,401846353,Frank McHugh,2,1,1
204951513,Mike Holding,412256116,Andy Sutton,2,1,1
204951513,Mike Holding,490170224,Jamie Matthews,2,0,2
204951513,Mike Holding,574248035,Tony Mulhern,2,0,2
204951513,Mike Holding,608140548,David Gillingham,2,0,2
204951513,Mike Holding,649240057,Mike Childs,2,2,0
204951513,Mike Holding,878576746,Jon Hall,2,1,1
204951513,Mike Holding,943667183,John Stone,2,0,2
204951513,Mike Holding,978156264,Bob Paine,2,2,0
207592931,(shorty) Gediminas Aleksandravicius,535728699,Fred Cooper,2,2,0
207592931,(shorty) Gediminas Aleksandravicius,613893140,Matt Warner,2,0,2
207592931,(shorty) Gediminas Aleksandravicius,623613383,Chris Marsh,2,0,2
207592931,(shorty) Gediminas Aleksandravicius,688778183,Dean Paice,2,0,2
207592931,(shorty) Gediminas Aleksandravicius,724342701,Nigel Lilley,2,2,0
207592931,(shorty) Gediminas Aleksandravicius,732415457,Barry Hall,2,1,1
207592931,(shorty) Gediminas Aleksandravicius,963206772,Dean Moore,2,1,1
212940364,Wayne Jenkinson,574248035,Tony Mulhern,2,2,0
213264678,Martin Hall,451309825,Maurice Wickens,2,1,1
213264678,Martin Hall,455401154,Kai Ellis,2,0,2
213264678,Martin Hall,506320151,Frank Taylor,2,0,2
213264678,Martin Hall,641692362,Bob Taylor,2,1,1
213264678,Martin Hall,717256135,Trevor Pickard,2,0,2
213264678,Martin Hall,809788967,Brett Williams,2,0,2
213264678,Martin Hall,845537273,Dave Gridley,2,0,2
213264678,Martin Hall,866506631,Mark Smith,2,1,1
216787426,Jack Perrin,223983583,Carl Wentworth,2,1,1
216787426,Jack Perrin,386517733,Ady Halley,2,2,0
216787426,Jack Perrin,495939788,Tyrone Davis,2,1,1
216787426,Jack Perrin,529382351,Greg Foat,2,2,0
216787426,Jack Perrin,688778183,Dean Paice,2,0,2
216787426,Jack Perrin,929636592,Danny Wilson,2,1,1
216787426,Jack Perrin,936624299,Peter Gallant,2,2,0
216787426,Jack Perrin,978156264,Bob Paine,2,2,0
223983583,Carl Wentworth,229719541,Scott Manning,2,1,1
223983583,Carl Wentworth,231445676,Tony Paice,2,1,1
223983583,Carl Wentworth,386517733,Ady Halley,2,0,2
223983583,Carl Wentworth,495939788,Tyrone Davis,2,2,0
223983583,Carl Wentworth,529382351,Greg Foat,2,1,1
223983583,Carl Wentworth,567624732,Dave Brampton,2,2,0
223983583,Carl Wentworth,573567936,Steve Marriott,2,0,2
223983583,Carl Wentworth,657320021,Brett Strevens,2,0,2
223983583,Carl Wentworth,670034050,John Muzio,2,0,2
223983583,Carl Wentworth,724342701,Nigel Lilley,2,1,1
223983583,Carl Wentworth,804381932,Ryan Harman,2,1,1
223983583,Carl Wentworth,867613624,Ian Dunhill,2,0,2
223983583,Carl Wentworth,899206834,Jez Downs,2,0,2
223983583,Carl Wentworth,966905561,Tony Dade,2,2,0
225247539,Barry Knight,225850882,John McLellan,2,1,1
225247539,Barry Knight,271464632,Paul Phillips,2,0,2
225247539,Barry Knight,291198629,Tony Burt,2,2,0
225247539,Barry Knight,319057545,Brendan Lambe,2,0,2
225247539,Barry Knight,411473516,Ray Canham,2,1,1
225247539,Barry Knight,567316488,Lee Millyard,2,1,1
225247539,Barry Knight,677110925,Jake Dunstall,2,1,1
225247539,Barry Knight,704007508,Alan Muir,2,0,2
225247539,Barry Knight,745152759,Kevin Jewell,2,2,0
225247539,Barry Knight,844676925,Kieran Williams,2,0,2
225247539,Barry Knight,858283721,Dave Dunstall,2,0,2
225247539,Barry Knight,970786910,Kevin Sorrell,2,0,2
225850882,John McLellan,275738778,John Da Silva,2,0,2
225850882,John McLellan,306438070,Martin Stocker,2,2,0
225850882,John McLellan,326342962,Geoff Randall,2,0,2
225850882,John McLellan,402257815,Jim Cumming,2,2,0
225850882,John McLellan,463709832,Danny Wong,2,1,1
225850882,John McLellan,579164381,Danny Cattell,2,2,0
225850882,John McLellan,670034050,John Muzio,2,0,2
225850882,John McLellan,713064363,John Trory,2,2,0
225850882,John McLellan,734416600,DON PENALVER,2,2,0
225850882,John McLellan,797313851,Dave Anderson,2,0,2
225850882,John McLellan,809788967,Brett Williams,2,1,1
225850882,John McLellan,845537273,Dave Gridley,2,0,2
225850882,John McLellan,880982797,Ray Hunter,2,1,1
225850882,John McLellan,899206834,Jez Downs,2,2,0
225850882,John McLellan,949603489,Pete Bennett,2,1,1
225850882,John McLellan,991823299,Miggy Louro,2,2,0
227209116,Peter Rawlinson,556095121,Tom Wright,2,2,0
227209116,Peter Rawlinson,971308746,Clive Harman,2,0,2
229719541,Scott Manning,258549102,Tony Lee,2,2,0
229719541,Scott Manning,293577764,Dave Crosskey,2,2,0
229719541,Scott Manning,301960429,Brian Collins,2,1,1
229719541,Scott Manning,386517733,Ady Halley,2,1,1
229719541,Scott Manning,402257815,Jim Cumming,2,2,0
229719541,Scott Manning,444339215,Steve Richards,2,2,0
229719541,Scott Manning,444350794,Richard Freeman,2,2,0
229719541,Scott Manning,464085958,Gerwyn Bowen,2,1,1
229719541,Scott Manning,495939788,Tyrone Davis,2,2,0
229719541,Scott Manning,546362444,Anthony Trory,2,2,0
229719541,Scott Manning,646614924,Norman Moye,2,2,0
229719541,Scott Manning,657320021,Brett Strevens,2,1,1
229719541,Scott Manning,713064363,John Trory,2,2,0
229719541,Scott Manning,745152759,Kevin Jewell,2,2,0
229719541,Scott Manning,822983250,Alasdair Pratt,2,2,0
229719541,Scott Manning,835713833,Olly Stewart,2,1,1
229719541,Scott Manning,858283721,Dave Dunstall,2,2,0
229719541,Scott Manning,884374645,Wayne Iddon,2,2,0
231445676,Tony Paice,271464632,Paul Phillips,2,1,1
231445676,Tony Paice,278731588,Lester Grice,2,0,2
231445676,Tony Paice,294944526,Rob Teanby,2,0,2
231445676,Tony Paice,349269645,Barry Thornton,2,2,0
231445676,Tony Paice,351143642,Michael Palmer,2,1,1
231445676,Tony Paice,394906196,Mick Mabbitt,2,1,1
231445676,Tony Paice,537640521,Ian Stoner,2,1,1
231445676,Tony Paice,567624732,Dave Brampton,2,1,1
231445676,Tony Paice,573567936,Steve Marriott,2,1,1
231445676,Tony Paice,579164381,Danny Cattell,2,0,2
231445676,Tony Paice,649240057,Mike Childs,2,2,0
231445676,Tony Paice,669385277,Steve Towler,2,0,2
231445676,Tony Paice,674307680,Neil McCafferty,2,2,0
231445676,Tony Paice,677110925,Jake Dunstall,2,1,1
231445676,Tony Paice,754250007,Freddie Blunden,2,1,1
231445676,Tony Paice,831214643,Tony Shipley,2,1,1
231445676,Tony Paice,884365412,Dave Haslam,2,1,1
231445676,Tony Paice,953512654,Les Berry,2,2,0
231975313,Danny English,506320151,Frank Taylor,2,1,1
231975313,Danny English,529382351,Greg Foat,2,1,1
231975313,Danny English,619390728,Steve Stylianou,2,0,2
231975313,Danny English,732321233,Nathan Brooks,2,1,1
231975313,Danny English,754250007,Freddie Blunden,2,0,2
231975313,Danny English,810143915,Ben Welfare,2,2,0
231975313,Danny English,848997254,Tom Parker,2,0,2
231975313,Danny English,858283721,Dave Dunstall,2,0,2
231975313,Danny English,899206834,Jez Downs,2,2,0
231975313,Danny English,957784480,Harry Banks,2,1,1
231975313,Danny English,970786910,Kevin Sorrell,2,1,1
231975313,Danny English,974385564,Danny Booker,2,0,2
246154671,Alan Gunn,266477517,Tony Baxter,2,1,1
246154671,Alan Gunn,490170224,Jamie Matthews,2,0,2
246154671,Alan Gunn,567624732,Dave Brampton,2,1,1
246154671,Alan Gunn,584652998,Harry Stone,2,1,1
246154671,Alan Gunn,598552542,John Colgan,2,1,1
246154671,Alan Gunn,704007508,Alan Muir,2,0,2
246154671,Alan Gunn,746406369,Loz O'Keefe,2,0,2
246154671,Alan Gunn,809984729,Neil Scutt,2,0,2
251261063,Rob Barnes,287057630,Darren Hearn,2,2,0
251261063,Rob Barnes,867613624,Ian Dunhill,2,1,1
254776886,Leighton Cole,573567936,Steve Marriott,2,2,0
254776886,Leighton Cole,971308746,Clive Harman,2,1,1
256835252,James Burton,430890681,Malcolm Cooper,2,1,1
256835252,James Burton,503528426,Larry Maloney,2,1,1
258340682,John Derret,598846718,Ben Sorrell,2,2,0
258340682,John Derret,949603489,Pete Bennett,2,2,0
258340682,John Derret,970786910,Kevin Sorrell,2,1,1
258549102,Tony Lee,386517733,Ady Halley,2,1,1
258549102,Tony Lee,820231590,Alan Rook,2,2,0
258549102,Tony Lee,843981340,Mark Glover,2,0,2
259288142,Dale Edmonds,949603489,Pete Bennett,2,0,2
259288142,Dale Edmonds,971308746,Clive Harman,2,1,1
266477517,Tony Baxter,291198629,Tony Burt,2,2,0
266477517,Tony Baxter,319057545,Brendan Lambe,2,0,2
266477517,Tony Baxter,491435492,Simon Price,2,1,1
266477517,Tony Baxter,498330760,Mo Collins,2,1,1
266477517,Tony Baxter,556095121,Tom Wright,2,1,1
266477517,Tony Baxter,584652998,Harry Stone,2,2,0
266477517,Tony Baxter,704007508,Alan Muir,2,0,2
266477517,Tony Baxter,943667183,John Stone,2,1,1
266591683,Chris Roche,278731588,Lester Grice,2,1,1
266591683,Chris Roche,501266206,David Fox,2,2,0
266591683,Chris Roche,608140548,David Gillingham,2,1,1
266591683,Chris Roche,662568995,Rob Wykes,2,0,2
266591683,Chris Roche,717256135,Trevor Pickard,2,1,1
266591683,Chris Roche,747966869,Richard Morgan,2,2,0
266591683,Chris Roche,899206834,Jez Downs,2,1,1
266591683,Chris Roche,929636592,Danny Wilson,2,2,0
271464632,Paul Phillips,301960429,Brian Collins,2,0,2
271464632,Paul Phillips,351143642,Michael Palmer,2,2,0
271464632,Paul Phillips,480772114,Kevin Ward,2,0,2
271464632,Paul Phillips,493830161,Luke Strevens,2,0,2
271464632,Paul Phillips,495939788,Tyrone Davis,2,2,0
271464632,Paul Phillips,503528426,Larry Maloney,2,1,1
271464632,Paul Phillips,504949622,Jimmy Moseley,2,2,0
271464632,Paul Phillips,529382351,Greg Foat,2,2,0
271464632,Paul Phillips,573567936,Steve Marriott,2,2,0
271464632,Paul Phillips,649240057,Mike Childs,2,2,0
271464632,Paul Phillips,670870044,David Flanagan,2,0,2
271464632,Paul Phillips,688252012,Sean Cooper,2,0,2
271464632,Paul Phillips,717256135,Trevor Pickard,2,1,1
271464632,Paul Phillips,802242736,Steve Hughes,2,0,2
271464632,Paul Phillips,835713833,Olly Stewart,2,1,1
271464632,Paul Phillips,858283721,Dave Dunstall,2,1,1
275738778,John Da Silva,291816585,Jim Somers,2,1,1
275738778,John Da Silva,301960429,Brian Collins,2,0,2
275738778,John Da Silva,426009127,Bav Patel,2,0,2
275738778,John Da Silva,677110925,Jake Dunstall,2,2,0
275738778,John Da Silva,717256135,Trevor Pickard,2,1,1
275738778,John Da Silva,954080507,Sam Corsby,2,1,1
278731588,Lester Grice,279543944,Peter Maurice,2,2,0
278731588,Lester Grice,289915561,Craig Dummer,2,0,2
278731588,Lester Grice,323907964,Russ Hughes,2,1,1
278731588,Lester Grice,463709832,Danny Wong,2,1,1
278731588,Lester Grice,503528426,Larry Maloney,2,2,0
278731588,Lester Grice,523395206,Jamie Lashmar,2,0,2
278731588,Lester Grice,588421173,Anish Gokool,2,0,2
278731588,Lester Grice,600385553,Darren Welfare,2,1,1
278731588,Lester Grice,764177688,Barry Martin,2,2,0
278731588,Lester Grice,797962517,Dave Lewis,2,1,1
278731588,Lester Grice,836895047,Ian McKay,2,1,1
278731588,Lester Grice,884365412,Dave Haslam,2,1,1
278731588,Lester Grice,947620111,Neil Cutler,2,2,0
278731588,Lester Grice,954297832,Pav Sareen,2,1,1
279543944,Peter Maurice,293577764,Dave Crosskey,2,1,1
279543944,Peter Maurice,326225304,Ian Raeburn,2,0,2
279543944,Peter Maurice,327948141,Ross Etheridge,2,0,2
279543944,Peter Maurice,351143642,Michael Palmer,2,1,1
279543944,Peter Maurice,394906196,Mick Mabbitt,2,0,2
279543944,Peter Maurice,409212679,Mark Chapman,2,0,2
279543944,Peter Maurice,411473516,Ray Canham,2,0,2
279543944,Peter Maurice,417786644,Eddie Collins,2,2,0
279543944,Peter Maurice,444339215,Steve Richards,2,0,2
279543944,Peter Maurice,463709832,Danny Wong,2,0,2
279543944,Peter Maurice,495939788,Tyrone Davis,2,2,0
279543944,Peter Maurice,503528426,Larry Maloney,2,2,0
279543944,Peter Maurice,579164381,Danny Cattell,2,1,1
279543944,Peter Maurice,804381932,Ryan Harman,2,1,1
279543944,Peter Maurice,843981340,Mark Glover,2,0,2
279543944,Peter Maurice,880982797,Ray Hunter,2,0,2
279543944,Peter Maurice,884365412,Dave Haslam,2,0,2
279543944,Peter Maurice,971308746,Clive Harman,2,1,1
282510619,Harry Green,721321839,Matt Peake,2,1,1
282510619,Harry Green,848997254,Tom Parker,2,1,1
282510619,Harry Green,954080507,Sam Corsby,2,1,1
287057630,Darren Hearn,294944526,Rob Teanby,2,0,2
287057630,Darren Hearn,360777082,Mark Bishop,2,0,2
287057630,Darren Hearn,409212679,Mark Chapman,2,1,1
287057630,Darren Hearn,423038309,Ian Fennell,2,0,2
287057630,Darren Hearn,426236650,Dave Parrott,2,1,1
287057630,Darren Hearn,480154054,Jim Dunstall,2,1,1
287057630,Darren Hearn,613893140,Matt Warner,2,0,2
287057630,Darren Hearn,728690686,Rick Rothschild,2,0,2
287057630,Darren Hearn,809984729,Neil Scutt,2,0,2
287057630,Darren Hearn,835713833,Olly Stewart,2,0,2
287057630,Darren Hearn,839313888,Kevin Chrysanthou,2,1,1
287057630,Darren Hearn,910809545,Blake Harman,2,0,2
287057630,Darren Hearn,966905561,Tony Dade,2,2,0
287057630,Darren Hearn,970786910,Kevin Sorrell,2,0,2
287057630,Darren Hearn,971308746,Clive Harman,2,0,2
287057630,Darren Hearn,978156264,Bob Paine,2,1,1
288891270,Lewis Copping,573567936,Steve Marriott,2,2,0
288891270,Lewis Copping,574248035,Tony Mulhern,2,2,0
288891270,Lewis Copping,737709582,Tony Browne,2,1,1
288891270,Lewis Copping,910809545,Blake Harman,2,2,0
289915561,Craig Dummer,426009127,Bav Patel,2,1,1
289915561,Craig Dummer,646410961,Paul Scorer,2,1,1
289915561,Craig Dummer,752709358,Chris Mason,2,0,2
289915561,Craig Dummer,754250007,Freddie Blunden,2,1,1
289915561,Craig Dummer,773216781,Sean Payne,2,1,1
291198629,Tony Burt,495939788,Tyrone Davis,2,2,0
291198629,Tony Burt,546362444,Anthony Trory,2,0,2
291198629,Tony Burt,688778183,Dean Paice,2,0,2
291816585,Jim Somers,293577764,Dave Crosskey,2,1,1
291816585,Jim Somers,351143642,Michael Palmer,2,0,2
291816585,Jim Somers,360777082,Mark Bishop,2,0,2
291816585,Jim Somers,392533233,Jack Wright,2,2,0
291816585,Jim Somers,394906196,Mick Mabbitt,2,0,2
291816585,Jim Somers,409212679,Mark Chapman,2,0,2
291816585,Jim Somers,410854609,Dave Lowe,2,1,1
291816585,Jim Somers,430890681,Malcolm Cooper,2,0,2
291816585,Jim Somers,674307680,Neil McCafferty,2,1,1
291816585,Jim Somers,688778183,Dean Paice,2,0,2
291816585,Jim Somers,713064363,John Trory,2,0,2
291816585,Jim Somers,733453947,Phil Canham,2,0,2
291816585,Jim Somers,788605510,Mark Rose,2,1,1
291816585,Jim Somers,822983250,Alasdair Pratt,2,0,2
291816585,Jim Somers,833156731,Jez Saunders,2,0,2
291816585,Jim Somers,884374645,Wayne Iddon,2,2,0
291816585,Jim Somers,970786910,Kevin Sorrell,2,0,2
293122482,Stuart Maplesden,444639447,Andy Wong,2,1,1
293122482,Stuart Maplesden,732321233,Nathan Brooks,2,1,1
293122482,Stuart Maplesden,733453947,Phil Canham,2,1,1
293122482,Stuart Maplesden,748064029,Paul Hughes,2,0,2
293122482,Stuart Maplesden,954639632,Derek Budde,2,2,0
293577764,Dave Crosskey,294944526,Rob Teanby,2,1,1
293577764,Dave Crosskey,351143642,Michael Palmer,2,0,2
293577764,Dave Crosskey,363402934,Rod Phillippe,2,1,1
293577764,Dave Crosskey,382970973,Paul Shaw,2,0,2
293577764,Dave Crosskey,480154054,Jim Dunstall,2,2,0
293577764,Dave Crosskey,501266206,David Fox,2,2,0
293577764,Dave Crosskey,556095121,Tom Wright,2,1,1
293577764,Dave Crosskey,598846718,Ben Sorrell,2,0,2
293577764,Dave Crosskey,713064363,John Trory,2,1,1
293577764,Dave Crosskey,815023707,David Senior,2,1,1
293577764,Dave Crosskey,845758589,Charlie James,2,1,1
293577764,Dave Crosskey,867613624,Ian Dunhill,2,1,1
293577764,Dave Crosskey,880982797,Ray Hunter,2,1,1
293577764,Dave Crosskey,953512654,Les Berry,2,1,1
294944526,Rob Teanby,363402934,Rod Phillippe,2,2,0
294944526,Rob Teanby,444339215,Steve Richards,2,2,0
294944526,Rob Teanby,495939788,Tyrone Davis,2,2,0
294944526,Rob Teanby,529382351,Greg Foat,2,2,0
294944526,Rob Teanby,579164381,Danny Cattell,2,0,2
294944526,Rob Teanby,649240057,Mike Childs,2,1,1
294944526,Rob Teanby,815023707,David Senior,2,2,0
294944526,Rob Teanby,843981340,Mark Glover,2,0,2
294944526,Rob Teanby,845758589,Charlie James,2,1,1
294944526,Rob Teanby,856755662,David Marsh,2,1,1
301960429,Brian Collins,382970973,Paul Shaw,2,1,1
301960429,Brian Collins,386517733,Ady Halley,2,2,0
301960429,Brian Collins,567624732,Dave Brampton,2,1,1
301960429,Brian Collins,669385277,Steve Towler,2,2,0
301960429,Brian Collins,713064363,John Trory,2,2,0
301960429,Brian Collins,733453947,Phil Canham,2,2,0
301960429,Brian Collins,831214643,Tony Shipley,2,2,0
301960429,Brian Collins,844676925,Kieran Williams,2,2,0
301960429,Brian Collins,884374645,Wayne Iddon,2,1,1
301960429,Brian Collins,943667183,John Stone,2,2,0
304563362,Dan Marchant,444339215,Steve Richards,2,1,1
304563362,Dan Marchant,490170224,Jamie Matthews,2,1,1
304563362,Dan Marchant,649078882,Richard Barrett,2,0,2
304563362,Dan Marchant,831214643,Tony Shipley,2,2,0
306438070,Martin Stocker,598846718,Ben Sorrell,2,1,1
306438070,Martin Stocker,680442672,Scott Lawson,2,1,1
306438070,Martin Stocker,719124015,Tony Power,2,0,2
306438070,Martin Stocker,788605510,Mark Rose,2,1,1
306438070,Martin Stocker,836895047,Ian McKay,2,1,1
306438070,Martin Stocker,866506631,Mark Smith,2,0,2
306438070,Martin Stocker,880982797,Ray Hunter,2,1,1
306438070,Martin Stocker,954297832,Pav Sareen,2,1,1
307140835,Tony Strange,323907964,Russ Hughes,2,1,1
307140835,Tony Strange,356397577,David Morgan,2,1,1
307140835,Tony Strange,646410961,Paul Scorer,2,1,1
307140835,Tony Strange,717256135,Trevor Pickard,2,2,0
307140835,Tony Strange,732321233,Nathan Brooks,2,2,0
307140835,Tony Strange,963958265,Rodney Moogan,2,2,0
319057545,Brendan Lambe,349269645,Barry Thornton,2,2,0
319057545,Brendan Lambe,392533233,Jack Wright,2,1,1
319057545,Brendan Lambe,394906196,Mick Mabbitt,2,0,2
319057545,Brendan Lambe,415524562,Dave King,2,2,0
319057545,Brendan Lambe,417786644,Eddie Collins,2,1,1
319057545,Brendan Lambe,423038309,Ian Fennell,2,0,2
319057545,Brendan Lambe,430602171,Steve Morgan,2,1,1
319057545,Brendan Lambe,490170224,Jamie Matthews,2,0,2
319057545,Brendan Lambe,495939788,Tyrone Davis,2,2,0
319057545,Brendan Lambe,501266206,David Fox,2,1,1
319057545,Brendan Lambe,506581042,Glen Dartnell,2,0,2
319057545,Brendan Lambe,567624732,Dave Brampton,2,1,1
319057545,Brendan Lambe,661923191,Steve Gardner,2,1,1
319057545,Brendan Lambe,713064363,John Trory,2,1,1
319057545,Brendan Lambe,724342701,Nigel Lilley,2,0,2
319057545,Brendan Lambe,746406369,Loz O'Keefe,2,1,1
319057545,Brendan Lambe,773216781,Sean Payne,2,1,1
319057545,Brendan Lambe,833156731,Jez Saunders,2,1,1
319057545,Brendan Lambe,845758589,Charlie James,2,1,1
319057545,Brendan Lambe,866506631,Mark Smith,2,0,2
319057545,Brendan Lambe,867613624,Ian Dunhill,2,0,2
319057545,Brendan Lambe,910809545,Blake Harman,2,0,2
319057545,Brendan Lambe,929636592,Danny Wilson,2,1,1
319057545,Brendan Lambe,943667183,John Stone,2,1,1
319057545,Brendan Lambe,954639632,Derek Budde,2,0,2
319057545,Brendan Lambe,963206772,Dean Moore,2,0,2
319057545,Brendan Lambe,971308746,Clive Harman,2,1,1
323907964,Russ Hughes,356397577,David Morgan,2,1,1
323907964,Russ Hughes,384960657,Dave Lewney,2,0,2
323907964,Russ Hughes,426009127,Bav Patel,2,1,1
323907964,Russ Hughes,654650203,Alan O'Sullivan,2,1,1
323907964,Russ Hughes,662568995,Rob Wykes,2,1,1
323907964,Russ Hughes,752709358,Chris Mason,2,1,1
323907964,Russ Hughes,764177688,Barry Martin,2,1,1
323907964,Russ Hughes,825399596,Pat Adams,2,1,1
323907964,Russ Hughes,865803068,Dave Jones,2,1,1
323907964,Russ Hughes,963958265,Rodney Moogan,2,2,0
326225304,Ian Raeburn,351143642,Michael Palmer,2,2,0
326225304,Ian Raeburn,713064363,John Trory,2,2,0
326225304,Ian Raeburn,804381932,Ryan Harman,2,1,1
326225304,Ian Raeburn,820231590,Alan Rook,2,1,1
326225304,Ian Raeburn,845758589,Charlie James,2,2,0
326342962,Geoff Randall,428102632,Anthony Flynn,2,1,1
326342962,Geoff Randall,463709832,Danny Wong,2,2,0
326342962,Geoff Randall,506581042,Glen Dartnell,2,0,2
326342962,Geoff Randall,523395206,Jamie Lashmar,2,0,2
326342962,Geoff Randall,608140548,David Gillingham,2,1,1
326342962,Geoff Randall,629014363,Lee Shepherd,2,0,2
326342962,Geoff Randall,649307517,Wes Kingham,2,2,0
326342962,Geoff Randall,662568995,Rob Wykes,2,1,1
326342962,Geoff Randall,669385277,Steve Towler,2,2,0
326342962,Geoff Randall,764177688,Barry Martin,2,1,1
326342962,Geoff Randall,948504778,Jon Fordham,2,1,1
326342962,Geoff Randall,963206772,Dean Moore,2,1,1
326342962,Geoff Randall,974385564,Danny Booker,2,1,1
327948141,Ross Etheridge,394906196,Mick Mabbitt,2,2,0
327948141,Ross Etheridge,429738563,Adam Buckingham,2,1,1
327948141,Ross Etheridge,463709832,Danny Wong,2,0,2
327948141,Ross Etheridge,490170224,Jamie Matthews,2,0,2
327948141,Ross Etheridge,501266206,David Fox,2,2,0
327948141,Ross Etheridge,612265840,Paul Honeysett,2,1,1
327948141,Ross Etheridge,719124015,Tony Power,2,1,1
327948141,Ross Etheridge,728690686,Rick Rothschild,2,1,1
327948141,Ross Etheridge,732415457,Barry Hall,2,0,2
327948141,Ross Etheridge,800114325,Roger Whiteley,2,0,2
327948141,Ross Etheridge,809647573,John Taylor,2,1,1
327948141,Ross Etheridge,833156731,Jez Saunders,2,2,0
327948141,Ross Etheridge,844676925,Kieran Williams,2,2,0
327948141,Ross Etheridge,901024459,Paul Charman,2,2,0
327948141,Ross Etheridge,949603489,Pete Bennett,2,0,2
327948141,Ross Etheridge,963206772,Dean Moore,2,1,1
327948141,Ross Etheridge,974385564,Danny Booker,2,0,2
341869673,Nigel Stilwell,356397577,David Morgan,2,0,2
341869673,Nigel Stilwell,390364577,Mark Bright,2,0,2
341869673,Nigel Stilwell,426009127,Bav Patel,2,1,1
341869673,Nigel Stilwell,480772114,Kevin Ward,2,2,0
341869673,Nigel Stilwell,717256135,Trevor Pickard,2,2,0
341869673,Nigel Stilwell,752709358,Chris Mason,2,1,1
341869673,Nigel Stilwell,773216781,Sean Payne,2,2,0
341869673,Nigel Stilwell,809568302,Mark Johnson,2,1,1
345558874,Zack Richardson,384960657,Dave Lewney,2,2,0
345558874,Zack Richardson,428102632,Anthony Flynn,2,2,0
345558874,Zack Richardson,444639447,Andy Wong,2,2,0
345558874,Zack Richardson,646410961,Paul Scorer,2,2,0
345558874,Zack Richardson,670256222,Connor Anderson,2,1,1
345558874,Zack Richardson,754250007,Freddie Blunden,2,2,0
345558874,Zack Richardson,794630189,Mark Coles,2,1,1
345558874,Zack Richardson,927588200,Tokki Yamaguchi,2,1,1
349269645,Barry Thornton,415524562,Dave King,2,1,1
349269645,Barry Thornton,493830161,Luke Strevens,2,0,2
349269645,Barry Thornton,567624732,Dave Brampton,2,0,2
349269645,Barry Thornton,598117191,Jerome Fowler,2,2,0
349269645,Barry Thornton,688252012,Sean Cooper,2,0,2
349269645,Barry Thornton,688778183,Dean Paice,2,0,2
349269645,Barry Thornton,704007508,Alan Muir,2,2,0
349269645,Barry Thornton,713064363,John Trory,2,1,1
349269645,Barry Thornton,788605510,Mark Rose,2,0,2
349269645,Barry Thornton,835713833,Olly Stewart,2,0,2
349269645,Barry Thornton,845758589,Charlie James,2,1,1
349269645,Barry Thornton,867613624,Ian Dunhill,2,0,2
349269645,Barry Thornton,901024459,Paul Charman,2,1,1
349269645,Barry Thornton,929636592,Danny Wilson,2,2,0
349269645,Barry Thornton,953512654,Les Berry,2,1,1
349269645,Barry Thornton,970786910,Kevin Sorrell,2,1,1
349269645,Barry Thornton,978156264,Bob Paine,2,2,0
351143642,Michael Palmer,360777082,Mark Bishop,2,0,2
351143642,Michael Palmer,392533233,Jack Wright,2,1,1
351143642,Michael Palmer,455401154,Kai Ellis,2,0,2
351143642,Michael Palmer,495939788,Tyrone Davis,2,2,0
351143642,Michael Palmer,506320151,Frank Taylor,2,2,0
351143642,Michael Palmer,535728699,Fred Cooper,2,1,1
351143642,Michael Palmer,567316488,Lee Millyard,2,1,1
351143642,Michael Palmer,641692362,Bob Taylor,2,0,2
351143642,Michael Palmer,688778183,Dean Paice,2,1,1
351143642,Michael Palmer,719124015,Tony Power,2,1,1
351143642,Michael Palmer,733453947,Phil Canham,2,0,2
351143642,Michael Palmer,745152759,Kevin Jewell,2,2,0
351143642,Michael Palmer,820231590,Alan Rook,2,2,0
351143642,Michael Palmer,845758589,Charlie James,2,1,1
351143642,Michael Palmer,866506631,Mark Smith,2,1,1
351143642,Michael Palmer,922772801,Nick Buonanno,2,1,1
351143642,Michael Palmer,963206772,Dean Moore,2,0,2
351143642,Michael Palmer,966905561,Tony Dade,2,1,1
351143642,Michael Palmer,970786910,Kevin Sorrell,2,0,2
351143642,Michael Palmer,978156264,Bob Paine,2,2,0
356397577,David Morgan,428102632,Anthony Flynn,2,2,0
356397577,David Morgan,444639447,Andy Wong,2,1,1
356397577,David Morgan,561171273,Andy Norman,2,2,0
356397577,David Morgan,666735933,Mike Collier,2,1,1
356397577,David Morgan,670256222,Connor Anderson,2,2,0
356397577,David Morgan,680442672,Scott Lawson,2,2,0
356397577,David Morgan,717256135,Trevor Pickard,2,2,0
356397577,David Morgan,797962517,Dave Lewis,2,1,1
356397577,David Morgan,802242736,Steve Hughes,2,2,0
356397577,David Morgan,809568302,Mark Johnson,2,2,0
356397577,David Morgan,825399596,Pat Adams,2,0,2
356397577,David Morgan,963958265,Rodney Moogan,2,2,0
360777082,Mark Bishop,410854609,Dave Lowe,2,2,0
360777082,Mark Bishop,493830161,Luke Strevens,2,1,1
360777082,Mark Bishop,728690686,Rick Rothschild,2,2,0
360777082,Mark Bishop,732415457,Barry Hall,2,0,2
360777082,Mark Bishop,788605510,Mark Rose,2,0,2
360777082,Mark Bishop,807603289,Kevin Gardner,2,2,0
360777082,Mark Bishop,866506631,Mark Smith,2,0,2
360777082,Mark Bishop,867613624,Ian Dunhill,2,2,0
360777082,Mark Bishop,889234854,Paul Smith,2,1,1
360777082,Mark Bishop,929636592,Danny Wilson,2,2,0
360777082,Mark Bishop,936624299,Peter Gallant,2,2,0
360777082,Mark Bishop,966905561,Tony Dade,2,2,0
360777082,Mark Bishop,970786910,Kevin Sorrell,2,1,1
363402934,Rod Phillippe,495939788,Tyrone Davis,2,2,0
363402934,Rod Phillippe,820231590,Alan Rook,2,0,2
363402934,Rod Phillippe,978156264,Bob Paine,2,2,0
364867274,Dave Lucking,386517733,Ady Halley,2,2,0
364867274,Dave Lucking,428102632,Anthony Flynn,2,1,1
364867274,Dave Lucking,463709832,Danny Wong,2,1,1
364867274,Dave Lucking,802242736,Steve Hughes,2,0,2
364867274,Dave Lucking,836895047,Ian McKay,2,1,1
382970973,Paul Shaw,436708540,Bob Henley,2,0,2
382970973,Paul Shaw,464085958,Gerwyn Bowen,2,1,1
382970973,Paul Shaw,574248035,Tony Mulhern,2,2,0
382970973,Paul Shaw,809647573,John Taylor,2,2,0
382970973,Paul Shaw,873916947,Geoff Akehurst,2,2,0
382970973,Paul Shaw,884374645,Wayne Iddon,2,1,1
382970973,Paul Shaw,899206834,Jez Downs,2,2,0
382970973,Paul Shaw,915035871,Kevin Graysmark,2,2,0
384960657,Dave Lewney,426009127,Bav Patel,2,0,2
384960657,Dave Lewney,444639447,Andy Wong,2,1,1
384960657,Dave Lewney,490170224,Jamie Matthews,2,1,1
384960657,Dave Lewney,579164381,Danny Cattell,2,2,0
384960657,Dave Lewney,619390728,Steve Stylianou,2,0,2
384960657,Dave Lewney,646410961,Paul Scorer,2,1,1
384960657,Dave Lewney,662568995,Rob Wykes,2,1,1
384960657,Dave Lewney,666735933,Mike Collier,2,1,1
384960657,Dave Lewney,732321233,Nathan Brooks,2,1,1
384960657,Dave Lewney,837429850,Paul Beecham,2,1,1
384960657,Dave Lewney,850059806,Heng Wong,2,2,0
386517733,Ady Halley,394906196,Mick Mabbitt,2,0,2
386517733,Ady Halley,426236650,Dave Parrott,2,2,0
386517733,Ady Halley,510918620,Robert Bowden,2,1,1
386517733,Ady Halley,535728699,Fred Cooper,2,1,1
386517733,Ady Halley,598846718,Ben Sorrell,2,1,1
386517733,Ady Halley,612265840,Paul Honeysett,2,0,2
386517733,Ady Halley,613893140,Matt Warner,2,1,1
386517733,Ady Halley,657320021,Brett Strevens,2,1,1
386517733,Ady Halley,677110925,Jake Dunstall,2,0,2
386517733,Ady Halley,688778183,Dean Paice,2,1,1
386517733,Ady Halley,732415457,Barry Hall,2,0,2
386517733,Ady Halley,737709582,Tony Browne,2,1,1
386517733,Ady Halley,746406369,Loz O'Keefe,2,0,2
386517733,Ady Halley,833156731,Jez Saunders,2,1,1
386517733,Ady Halley,845537273,Dave Gridley,2,1,1
386517733,Ady Halley,899206834,Jez Downs,2,0,2
386517733,Ady Halley,963206772,Dean Moore,2,0,2
386517733,Ady Halley,968651401,Ryan Grover,2,0,2
386517733,Ady Halley,980908578,Jake Whatman,2,2,0
386517733,Ady Halley,982531289,Rory Griffiths,2,0,2
390364577,Mark Bright,506581042,Glen Dartnell,2,2,0
390364577,Mark Bright,617751649,Lee Simpson,2,1,1
390364577,Mark Bright,662568995,Rob Wykes,2,2,0
390364577,Mark Bright,670256222,Connor Anderson,2,1,1
390364577,Mark Bright,748064029,Paul Hughes,2,1,1
390364577,Mark Bright,773216781,Sean Payne,2,2,0
390364577,Mark Bright,957784480,Harry Banks,2,1,1
392533233,Jack Wright,409212679,Mark Chapman,2,0,2
392533233,Jack Wright,444350794,Richard Freeman,2,1,1
392533233,Jack Wright,546362444,Anthony Trory,2,1,1
392533233,Jack Wright,820231590,Alan Rook,2,2,0
392533233,Jack Wright,835713833,Olly Stewart,2,0,2
392533233,Jack Wright,858283721,Dave Dunstall,2,1,1
394906196,Mick Mabbitt,402257815,Jim Cumming,2,1,1
394906196,Mick Mabbitt,429738563,Adam Buckingham,2,0,2
394906196,Mick Mabbitt,480154054,Jim Dunstall,2,1,1
394906196,Mick Mabbitt,567316488,Lee Millyard,2,0,2
394906196,Mick Mabbitt,623613383,Chris Marsh,2,0,2
394906196,Mick Mabbitt,732415457,Barry Hall,2,0,2
394906196,Mick Mabbitt,809984729,Neil Scutt,2,1,1
394906196,Mick Mabbitt,839313888,Kevin Chrysanthou,2,1,1
394906196,Mick Mabbitt,951468676,Steve Burchett,2,0,2
394906196,Mick Mabbitt,953512654,Les Berry,2,0,2
394906196,Mick Mabbitt,970786910,Kevin Sorrell,2,0,2
401846353,Frank McHugh,630748783,Darren Hills,2,2,0
401846353,Frank McHugh,978156264,Bob Paine,2,1,1
402257815,Jim Cumming,412256116,Andy Sutton,2,0,2
402257815,Jim Cumming,535728699,Fred Cooper,2,2,0
402257815,Jim Cumming,612265840,Paul Honeysett,2,2,0
402257815,Jim Cumming,757827662,Clive Freestone,2,0,2
402257815,Jim Cumming,809984729,Neil Scutt,2,1,1
402257815,Jim Cumming,845758589,Charlie James,2,2,0
402257815,Jim Cumming,884374645,Wayne Iddon,2,2,0
402257815,Jim Cumming,889234854,Paul Smith,2,0,2
402257815,Jim Cumming,899206834,Jez Downs,2,0,2
402257815,Jim Cumming,922772801,Nick Buonanno,2,0,2
402257815,Jim Cumming,970786910,Kevin Sorrell,2,0,2
402257815,Jim Cumming,974385564,Danny Booker,2,0,2
409212679,Mark Chapman,444350794,Richard Freeman,2,2,0
409212679,Mark Chapman,484159049,Tommy Wright,2,1,1
409212679,Mark Chapman,506581042,Glen Dartnell,2,1,1
409212679,Mark Chapman,546362444,Anthony Trory,2,0,2
409212679,Mark Chapman,598117191,Jerome Fowler,2,1,1
409212679,Mark Chapman,670034050,John Muzio,2,0,2
409212679,Mark Chapman,713064363,John Trory,2,1,1
409212679,Mark Chapman,724342701,Nigel Lilley,2,2,0
409212679,Mark Chapman,737709582,Tony Browne,2,1,1
409212679,Mark Chapman,809647573,John Taylor,2,2,0
409212679,Mark Chapman,809984729,Neil Scutt,2,1,1
409212679,Mark Chapman,815023707,David Senior,2,2,0
409212679,Mark Chapman,833156731,Jez Saunders,2,1,1
409212679,Mark Chapman,899206834,Jez Downs,2,1,1
409212679,Mark Chapman,943667183,John Stone,2,2,0
409212679,Mark Chapman,949603489,Pete Bennett,2,0,2
409212679,Mark Chapman,978156264,Bob Paine,2,2,0
410854609,Dave Lowe,535728699,Fred Cooper,2,2,0
410854609,Dave Lowe,537640521,Ian Stoner,2,0,2
410854609,Dave Lowe,704007508,Alan Muir,2,0,2
410854609,Dave Lowe,815023707,David Senior,2,1,1
410854609,Dave Lowe,884374645,Wayne Iddon,2,1,1
411473516,Ray Canham,451309825,Maurice Wickens,2,1,1
411473516,Ray Canham,455401154,Kai Ellis,2,2,0
411473516,Ray Canham,498330760,Mo Collins,2,2,0
411473516,Ray Canham,506320151,Frank Taylor,2,0,2
411473516,Ray Canham,529382351,Greg Foat,2,2,0
411473516,Ray Canham,598117191,Jerome Fowler,2,1,1
411473516,Ray Canham,612265840,Paul Honeysett,2,1,1
411473516,Ray Canham,654650203,Alan O'Sullivan,2,1,1
411473516,Ray Canham,713064363,John Trory,2,2,0
411473516,Ray Canham,788605510,Mark Rose,2,1,1
411473516,Ray Canham,809647573,John Taylor,2,1,1
411473516,Ray Canham,867613624,Ian Dunhill,2,1,1
411473516,Ray Canham,878576746,Jon Hall,2,1,1
411473516,Ray Canham,889234854,Paul Smith,2,0,2
411473516,Ray Canham,954080507,Sam Corsby,2,0,2
412256116,Andy Sutton,420230435,Jack Fielder,2,1,1
412256116,Andy Sutton,423038309,Ian Fennell,2,1,1
412256116,Andy Sutton,506320151,Frank Taylor,2,2,0
412256116,Andy Sutton,629014363,Lee Shepherd,2,1,1
412256116,Andy Sutton,713064363,John Trory,2,2,0
412256116,Andy Sutton,732321233,Nathan Brooks,2,1,1
412256116,Andy Sutton,873916947,Geoff Akehurst,2,2,0
412256116,Andy Sutton,878576746,Jon Hall,2,2,0
412256116,Andy Sutton,884365412,Dave Haslam,2,0,2
412256116,Andy Sutton,889234854,Paul Smith,2,1,1
412256116,Andy Sutton,901024459,Paul Charman,2,1,1
412256116,Andy Sutton,949603489,Pete Bennett,2,0,2
415524562,Dave King,480154054,Jim Dunstall,2,2,0
415524562,Dave King,556095121,Tom Wright,2,1,1
415524562,Dave King,573567936,Steve Marriott,2,1,1
415524562,Dave King,773216781,Sean Payne,2,0,2
415524562,Dave King,845758589,Charlie James,2,2,0
415524562,Dave King,966905561,Tony Dade,2,0,2
417786644,Eddie Collins,430890681,Malcolm Cooper,2,1,1
417786644,Eddie Collins,529382351,Greg Foat,2,0,2
417786644,Eddie Collins,535728699,Fred Cooper,2,0,2
417786644,Eddie Collins,612265840,Paul Honeysett,2,2,0
417786644,Eddie Collins,688252012,Sean Cooper,2,0,2
417786644,Eddie Collins,733453947,Phil Canham,2,0,2
417786644,Eddie Collins,737709582,Tony Browne,2,0,2
417786644,Eddie Collins,746406369,Loz O'Keefe,2,0,2
417786644,Eddie Collins,831214643,Tony Shipley,2,0,2
417786644,Eddie Collins,922772801,Nick Buonanno,2,0,2
417786644,Eddie Collins,929636592,Danny Wilson,2,0,2
417786644,Eddie Collins,943667183,John Stone,2,1,1
417786644,Eddie Collins,953512654,Les Berry,2,0,2
417786644,Eddie Collins,978156264,Bob Paine,2,1,1
420230435,Jack Fielder,464085958,Gerwyn Bowen,2,2,0
420230435,Jack Fielder,510918620,Robert Bowden,2,2,0
420230435,Jack Fielder,573567936,Steve Marriott,2,2,0
420230435,Jack Fielder,669385277,Steve Towler,2,2,0
420230435,Jack Fielder,670034050,John Muzio,2,2,0
420230435,Jack Fielder,713064363,John Trory,2,2,0
420230435,Jack Fielder,899206834,Jez Downs,2,2,0
423038309,Ian Fennell,574248035,Tony Mulhern,2,2,0
423038309,Ian Fennell,732415457,Barry Hall,2,2,0
423038309,Ian Fennell,889234854,Paul Smith,2,1,1
423038309,Ian Fennell,901024459,Paul Charman,2,2,0
426009127,Bav Patel,506581042,Glen Dartnell,2,2,0
426009127,Bav Patel,666735933,Mike Collier,2,0,2
426009127,Bav Patel,717256135,Trevor Pickard,2,2,0
426009127,Bav Patel,773216781,Sean Payne,2,0,2
426009127,Bav Patel,802242736,Steve Hughes,2,1,1
426009127,Bav Patel,974385564,Danny Booker,2,2,0
426236650,Dave Parrott,535728699,Fred Cooper,2,0,2
426236650,Dave Parrott,688778183,Dean Paice,2,0,2
426236650,Dave Parrott,845758589,Charlie James,2,1,1
426236650,Dave Parrott,966905561,Tony Dade,2,0,2
428102632,Anthony Flynn,444639447,Andy Wong,2,1,1
428102632,Anthony Flynn,629014363,Lee Shepherd,2,0,2
428102632,Anthony Flynn,662568995,Rob Wykes,2,0,2
428102632,Anthony Flynn,732321233,Nathan Brooks,2,2,0
428102632,Anthony Flynn,809647573,John Taylor,2,2,0
428102632,Anthony Flynn,825399596,Pat Adams,2,1,1
428102632,Anthony Flynn,837429850,Paul Beecham,2,2,0
428102632,Anthony Flynn,850059806,Heng Wong,2,1,1
428102632,Anthony Flynn,876526526,Ash Bull,2,0,2
428102632,Anthony Flynn,954297832,Pav Sareen,2,1,1
428102632,Anthony Flynn,963958265,Rodney Moogan,2,0,2
430602171,Steve Morgan,800114325,Roger Whiteley,2,0,2
430890681,Malcolm Cooper,501266206,David Fox,2,2,0
430890681,Malcolm Cooper,504949622,Jimmy Moseley,2,1,1
430890681,Malcolm Cooper,506320151,Frank Taylor,2,2,0
430890681,Malcolm Cooper,556095121,Tom Wright,2,0,2
430890681,Malcolm Cooper,646614924,Norman Moye,2,1,1
430890681,Malcolm Cooper,649240057,Mike Childs,2,2,0
430890681,Malcolm Cooper,704007508,Alan Muir,2,0,2
430890681,Malcolm Cooper,844676925,Kieran Williams,2,2,0
430890681,Malcolm Cooper,910809545,Blake Harman,2,1,1
430890681,Malcolm Cooper,929636592,Danny Wilson,2,0,2
430890681,Malcolm Cooper,953512654,Les Berry,2,0,2
436708540,Bob Henley,608140548,David Gillingham,2,0,2
436708540,Bob Henley,654650203,Alan O'Sullivan,2,1,1
436708540,Bob Henley,673242409,Alan Colvin,2,2,0
436708540,Bob Henley,719124015,Tony Power,2,0,2
436708540,Bob Henley,721321839,Matt Peake,2,1,1
436708540,Bob Henley,732321233,Nathan Brooks,2,0,2
436708540,Bob Henley,733453947,Phil Canham,2,1,1
436708540,Bob Henley,809788967,Brett Williams,2,0,2
436708540,Bob Henley,822983250,Alasdair Pratt,2,0,2
436708540,Bob Henley,889234854,Paul Smith,2,0,2
436708540,Bob Henley,901024459,Paul Charman,2,1,1
444339215,Steve Richards,529382351,Greg Foat,2,1,1
444339215,Steve Richards,657320021,Brett Strevens,2,1,1
444339215,Steve Richards,804381932,Ryan Harman,2,2,0
444350794,Richard Freeman,501266206,David Fox,2,2,0
444350794,Richard Freeman,529382351,Greg Foat,2,2,0
444350794,Richard Freeman,535728699,Fred Cooper,2,2,0
444350794,Richard Freeman,567316488,Lee Millyard,2,0,2
444350794,Richard Freeman,670034050,John Muzio,2,2,0
444350794,Richard Freeman,713064363,John Trory,2,0,2
444350794,Richard Freeman,732415457,Barry Hall,2,1,1
444350794,Richard Freeman,805165161,Steve Owen,2,0,2
444350794,Richard Freeman,809647573,John Taylor,2,1,1
444350794,Richard Freeman,809984729,Neil Scutt,2,2,0
444350794,Richard Freeman,845758589,Charlie James,2,2,0
444350794,Richard Freeman,866506631,Mark Smith,2,0,2
444350794,Richard Freeman,922772801,Nick Buonanno,2,1,1
444350794,Richard Freeman,971308746,Clive Harman,2,0,2
444639447,Andy Wong,837429850,Paul Beecham,2,1,1
444639447,Andy Wong,957784480,Harry Banks,2,1,1
449331249,Dan Tanner,529382351,Greg Foat,2,0,2
449331249,Dan Tanner,573567936,Steve Marriott,2,0,2
449331249,Dan Tanner,733453947,Phil Canham,2,0,2
449331249,Dan Tanner,831214643,Tony Shipley,2,1,1
449331249,Dan Tanner,978156264,Bob Paine,2,2,0
451309825,Maurice Wickens,733453947,Phil Canham,2,1,1
451309825,Maurice Wickens,971308746,Clive Harman,2,1,1
455401154,Kai Ellis,463709832,Danny Wong,2,1,1
455401154,Kai Ellis,484159049,Tommy Wright,2,2,0
455401154,Kai Ellis,670034050,John Muzio,2,0,2
455401154,Kai Ellis,800114325,Roger Whiteley,2,2,0
455401154,Kai Ellis,970786910,Kevin Sorrell,2,1,1
463709832,Danny Wong,484159049,Tommy Wright,2,1,1
463709832,Danny Wong,529382351,Greg Foat,2,2,0
463709832,Danny Wong,561171273,Andy Norman,2,0,2
463709832,Danny Wong,641692362,Bob Taylor,2,1,1
463709832,Danny Wong,649307517,Wes Kingham,2,2,0
463709832,Danny Wong,670034050,John Muzio,2,2,0
463709832,Danny Wong,719124015,Tony Power,2,1,1
463709832,Danny Wong,721321839,Matt Peake,2,2,0
463709832,Danny Wong,734416600,DON PENALVER,2,0,2
463709832,Danny Wong,748064029,Paul Hughes,2,0,2
463709832,Danny Wong,831214643,Tony Shipley,2,0,2
463709832,Danny Wong,949603489,Pete Bennett,2,0,2
463709832,Danny Wong,954080507,Sam Corsby,2,2,0
463709832,Danny Wong,957784480,Harry Banks,2,1,1
463709832,Danny Wong,963206772,Dean Moore,2,2,0
464085958,Gerwyn Bowen,732415457,Barry Hall,2,1,1
464085958,Gerwyn Bowen,733453947,Phil Canham,2,1,1
464085958,Gerwyn Bowen,831214643,Tony Shipley,2,0,2
464085958,Gerwyn Bowen,954080507,Sam Corsby,2,1,1
479705187,Keith McQueen,612265840,Paul Honeysett,2,0,2
480154054,Jim Dunstall,546362444,Anthony Trory,2,0,2
480154054,Jim Dunstall,649240057,Mike Childs,2,1,1
480154054,Jim Dunstall,873916947,Geoff Akehurst,2,1,1
480154054,Jim Dunstall,971308746,Clive Harman,2,1,1
480154054,Jim Dunstall,978156264,Bob Paine,2,1,1
480772114,Kevin Ward,608140548,David Gillingham,2,0,2
480772114,Kevin Ward,717256135,Trevor Pickard,2,2,0
484159049,Tommy Wright,493830161,Luke Strevens,2,0,2
484159049,Tommy Wright,501266206,David Fox,2,2,0
484159049,Tommy Wright,670034050,John Muzio,2,1,1
484159049,Tommy Wright,721321839,Matt Peake,2,1,1
484159049,Tommy Wright,728690686,Rick Rothschild,2,0,2
484159049,Tommy Wright,736672590,Dean Perry,2,1,1
484159049,Tommy Wright,737709582,Tony Browne,2,0,2
484159049,Tommy Wright,747966869,Richard Morgan,2,2,0
484159049,Tommy Wright,815023707,David Senior,2,2,0
484159049,Tommy Wright,848997254,Tom Parker,2,0,2
484159049,Tommy Wright,880982797,Ray Hunter,2,2,0
484159049,Tommy Wright,910809545,Blake Harman,2,2,0
484159049,Tommy Wright,943667183,John Stone,2,2,0
484159049,Tommy Wright,966905561,Tony Dade,2,1,1
484159049,Tommy Wright,978156264,Bob Paine,2,2,0
490170224,Jamie Matthews,613893140,Matt Warner,2,2,0
490170224,Jamie Matthews,670256222,Connor Anderson,2,0,2
490170224,Jamie Matthews,713064363,John Trory,2,2,0
490170224,Jamie Matthews,719124015,Tony Power,2,2,0
490170224,Jamie Matthews,736672590,Dean Perry,2,1,1
490170224,Jamie Matthews,815023707,David Senior,2,2,0
490170224,Jamie Matthews,844676925,Kieran Williams,2,1,1
490170224,Jamie Matthews,848997254,Tom Parker,2,1,1
490170224,Jamie Matthews,878576746,Jon Hall,2,1,1
490170224,Jamie Matthews,922772801,Nick Buonanno,2,1,1
490170224,Jamie Matthews,948504778,Jon Fordham,2,2,0
490170224,Jamie Matthews,968651401,Ryan Grover,2,2,0
490170224,Jamie Matthews,974385564,Danny Booker,2,1,1
493830161,Luke Strevens,598117191,Jerome Fowler,2,2,0
493830161,Luke Strevens,613893140,Matt Warner,2,1,1
493830161,Luke Strevens,719124015,Tony Power,2,2,0
493830161,Luke Strevens,788605510,Mark Rose,2,0,2
493830161,Luke Strevens,800114325,Roger Whiteley,2,1,1
493830161,Luke Strevens,809984729,Neil Scutt,2,2,0
493830161,Luke Strevens,833156731,Jez Saunders,2,2,0
493830161,Luke Strevens,963206772,Dean Moore,2,1,1
495939788,Tyrone Davis,529382351,Greg Foat,2,0,2
495939788,Tyrone Davis,677110925,Jake Dunstall,2,0,2
495939788,Tyrone Davis,704007508,Alan Muir,2,0,2
495939788,Tyrone Davis,815023707,David Senior,2,0,2
495939788,Tyrone Davis,820231590,Alan Rook,2,1,1
495939788,Tyrone Davis,831214643,Tony Shipley,2,0,2
495939788,Tyrone Davis,845758589,Charlie James,2,0,2
495939788,Tyrone Davis,867613624,Ian Dunhill,2,0,2
495939788,Tyrone Davis,880982797,Ray Hunter,2,0,2
495939788,Tyrone Davis,936624299,Peter Gallant,2,0,2
498330760,Mo Collins,501266206,David Fox,2,1,1
498330760,Mo Collins,649240057,Mike Childs,2,1,1
498330760,Mo Collins,733453947,Phil Canham,2,1,1
498330760,Mo Collins,831214643,Tony Shipley,2,0,2
498330760,Mo Collins,867613624,Ian Dunhill,2,0,2
498330760,Mo Collins,936624299,Peter Gallant,2,1,1
498330760,Mo Collins,966905561,Tony Dade,2,1,1
498330760,Mo Collins,970786910,Kevin Sorrell,2,0,2
501266206,David Fox,574248035,Tony Mulhern,2,0,2
501266206,David Fox,613893140,Matt Warner,2,1,1
501266206,David Fox,669385277,Steve Towler,2,1,1
501266206,David Fox,732415457,Barry Hall,2,0,2
501266206,David Fox,809984729,Neil Scutt,2,1,1
501266206,David Fox,831214643,Tony Shipley,2,1,1
501266206,David Fox,844676925,Kieran Williams,2,1,1
501266206,David Fox,889234854,Paul Smith,2,1,1
501266206,David Fox,978156264,Bob Paine,2,2,0
503528426,Larry Maloney,600385553,Darren Welfare,2,0,2
506320151,Frank Taylor,574248035,Tony Mulhern,2,0,2
506320151,Frank Taylor,674307680,Neil McCafferty,2,1,1
506320151,Frank Taylor,752709358,Chris Mason,2,0,2
506320151,Frank Taylor,833156731,Jez Saunders,2,1,1
506320151,Frank Taylor,866506631,Mark Smith,2,1,1
506320151,Frank Taylor,901024459,Paul Charman,2,2,0
506320151,Frank Taylor,970786910,Kevin Sorrell,2,1,1
506581042,Glen Dartnell,523395206,Jamie Lashmar,2,0,2
506581042,Glen Dartnell,561171273,Andy Norman,2,0,2
506581042,Glen Dartnell,612265840,Paul Honeysett,2,2,0
506581042,Glen Dartnell,670256222,Connor Anderson,2,0,2
506581042,Glen Dartnell,688252012,Sean Cooper,2,2,0
506581042,Glen Dartnell,752709358,Chris Mason,2,1,1
506581042,Glen Dartnell,797962517,Dave Lewis,2,1,1
506581042,Glen Dartnell,954297832,Pav Sareen,2,2,0
510918620,Robert Bowden,573567936,Steve Marriott,2,2,0
510918620,Robert Bowden,612265840,Paul Honeysett,2,1,1
510918620,Robert Bowden,670034050,John Muzio,2,1,1
510918620,Robert Bowden,915035871,Kevin Graysmark,2,0,2
515177310,James Da Costa,688252012,Sean Cooper,2,1,1
515177310,James Da Costa,732415457,Barry Hall,2,0,2
515177310,James Da Costa,852327692,Andy Fletcher,2,2,0
515177310,James Da Costa,963206772,Dean Moore,2,2,0
515186402,Ben Evans,732321233,Nathan Brooks,2,2,0
515186402,Ben Evans,754250007,Freddie Blunden,2,2,0
515186402,Ben Evans,794630189,Mark Coles,2,0,2
515186402,Ben Evans,797962517,Dave Lewis,2,1,1
515186402,Ben Evans,802242736,Steve Hughes,2,2,0
515186402,Ben Evans,837429850,Paul Beecham,2,2,0
515186402,Ben Evans,927588200,Tokki Yamaguchi,2,1,1
515186402,Ben Evans,947143243,Chris Davis,2,1,1
523395206,Jamie Lashmar,598846718,Ben Sorrell,2,2,0
523395206,Jamie Lashmar,748064029,Paul Hughes,2,0,2
523395206,Jamie Lashmar,764177688,Barry Martin,2,1,1
523395206,Jamie Lashmar,797962517,Dave Lewis,2,2,0
523395206,Jamie Lashmar,809984729,Neil Scutt,2,2,0
523395206,Jamie Lashmar,876526526,Ash Bull,2,0,2
523395206,Jamie Lashmar,948504778,Jon Fordham,2,2,0
523395206,Jamie Lashmar,954297832,Pav Sareen,2,2,0
523395206,Jamie Lashmar,978156264,Bob Paine,2,2,0
524571340,Mohammed Alhdi,867613624,Ian Dunhill,2,0,2
529382351,Greg Foat,535728699,Fred Cooper,2,1,1
529382351,Greg Foat,598117191,Jerome Fowler,2,0,2
529382351,Greg Foat,661923191,Steve Gardner,2,0,2
529382351,Greg Foat,688252012,Sean Cooper,2,1,1
529382351,Greg Foat,733453947,Phil Canham,2,0,2
529382351,Greg Foat,809984729,Neil Scutt,2,1,1
529382351,Greg Foat,820231590,Alan Rook,2,2,0
529382351,Greg Foat,836895047,Ian McKay,2,0,2
529382351,Greg Foat,845758589,Charlie James,2,1,1
529382351,Greg Foat,856755662,David Marsh,2,0,2
529382351,Greg Foat,948504778,Jon Fordham,2,0,2
529382351,Greg Foat,966905561,Tony Dade,2,0,2
529382351,Greg Foat,970786910,Kevin Sorrell,2,1,1
535728699,Fred Cooper,550273589,George Warner,2,2,0
535728699,Fred Cooper,556095121,Tom Wright,2,2,0
535728699,Fred Cooper,612265840,Paul Honeysett,2,2,0
535728699,Fred Cooper,670870044,David Flanagan,2,1,1
535728699,Fred Cooper,733453947,Phil Canham,2,0,2
535728699,Fred Cooper,745152759,Kevin Jewell,2,1,1
535728699,Fred Cooper,833156731,Jez Saunders,2,2,0
535728699,Fred Cooper,866506631,Mark Smith,2,1,1
535728699,Fred Cooper,867613624,Ian Dunhill,2,0,2
535728699,Fred Cooper,873916947,Geoff Akehurst,2,2,0
535728699,Fred Cooper,963206772,Dean Moore,2,0,2
535728699,Fred Cooper,966905561,Tony Dade,2,2,0
535728699,Fred Cooper,970786910,Kevin Sorrell,2,0,2
535728699,Fred Cooper,971308746,Clive Harman,2,2,0
537640521,Ian Stoner,598846718,Ben Sorrell,2,1,1
537640521,Ian Stoner,608140548,David Gillingham,2,0,2
537640521,Ian Stoner,612265840,Paul Honeysett,2,2,0
537640521,Ian Stoner,623613383,Chris Marsh,2,0,2
537640521,Ian Stoner,688252012,Sean Cooper,2,2,0
537640521,Ian Stoner,713064363,John Trory,2,1,1
537640521,Ian Stoner,724342701,Nigel Lilley,2,1,1
537640521,Ian Stoner,728690686,Rick Rothschild,2,1,1
537640521,Ian Stoner,733453947,Phil Canham,2,1,1
537640521,Ian Stoner,745152759,Kevin Jewell,2,1,1
537640521,Ian Stoner,836895047,Ian McKay,2,1,1
537640521,Ian Stoner,858283721,Dave Dunstall,2,0,2
537640521,Ian Stoner,910809545,Blake Harman,2,2,0
546362444,Anthony Trory,820231590,Alan Rook,2,1,1
546362444,Anthony Trory,845758589,Charlie James,2,1,1
556095121,Tom Wright,649078882,Richard Barrett,2,0,2
556095121,Tom Wright,704007508,Alan Muir,2,1,1
556095121,Tom Wright,848997254,Tom Parker,2,1,1
556095121,Tom Wright,951468676,Steve Burchett,2,0,2
560540608,Mark Siddle,669385277,Steve Towler,2,1,1
560540608,Mark Siddle,835713833,Olly Stewart,2,0,2
560540608,Mark Siddle,899206834,Jez Downs,2,1,1
561171273,Andrew Norman,963958265,Rodney Moogan,2,1,1
561171273,Andy Norman,662568995,Rob Wykes,2,1,1
561171273,Andy Norman,748064029,Paul Hughes,2,2,0
567316488,Lee Millyard,569369123,Chris King,2,2,0
567316488,Lee Millyard,598117191,Jerome Fowler,2,2,0
567316488,Lee Millyard,613893140,Matt Warner,2,0,2
567316488,Lee Millyard,719124015,Tony Power,2,1,1
567316488,Lee Millyard,736672590,Dean Perry,2,0,2
567316488,Lee Millyard,788605510,Mark Rose,2,0,2
567316488,Lee Millyard,810143915,Ben Welfare,2,0,2
567316488,Lee Millyard,835713833,Olly Stewart,2,1,1
567316488,Lee Millyard,971308746,Clive Harman,2,0,2
567624732,Dave Brampton,670870044,David Flanagan,2,0,2
567624732,Dave Brampton,713064363,John Trory,2,1,1
567624732,Dave Brampton,884374645,Wayne Iddon,2,1,1
567624732,Dave Brampton,966905561,Tony Dade,2,0,2
573567936,Steve Marriott,579164381,Danny Cattell,2,1,1
573567936,Steve Marriott,649240057,Mike Childs,2,1,1
573567936,Steve Marriott,657320021,Brett Strevens,2,1,1
573567936,Steve Marriott,669385277,Steve Towler,2,0,2
573567936,Steve Marriott,724342701,Nigel Lilley,2,2,0
573567936,Steve Marriott,804381932,Ryan Harman,2,1,1
573567936,Steve Marriott,815023707,David Senior,2,2,0
573567936,Steve Marriott,858283721,Dave Dunstall,2,1,1
573567936,Steve Marriott,884374645,Wayne Iddon,2,1,1
573567936,Steve Marriott,899206834,Jez Downs,2,2,0
573567936,Steve Marriott,929636592,Danny Wilson,2,0,2
574248035,Tony Mulhern,629014363,Lee Shepherd,2,1,1
574248035,Tony Mulhern,654650203,Alan O'Sullivan,2,0,2
574248035,Tony Mulhern,667627563,Aeran Jenkinson,2,0,2
574248035,Tony Mulhern,719124015,Tony Power,2,1,1
574248035,Tony Mulhern,734416600,DON PENALVER,2,1,1
574248035,Tony Mulhern,736672590,Dean Perry,2,1,1
574248035,Tony Mulhern,833156731,Jez Saunders,2,1,1
574248035,Tony Mulhern,835713833,Olly Stewart,2,0,2
574248035,Tony Mulhern,848997254,Tom Parker,2,1,1
574248035,Tony Mulhern,949603489,Pete Bennett,2,1,1
579164381,Danny Cattell,641692362,Bob Taylor,2,2,0
579164381,Danny Cattell,800114325,Roger Whiteley,2,2,0
579164381,Danny Cattell,858283721,Dave Dunstall,2,1,1
579164381,Danny Cattell,954080507,Sam Corsby,2,2,0
579164381,Danny Cattell,968651401,Ryan Grover,2,1,1
584652998,Harry Stone,688252012,Sean Cooper,2,0,2
584652998,Harry Stone,820231590,Alan Rook,2,1,1
584652998,Harry Stone,978156264,Bob Paine,2,1,1
597923939,David Lovegrove,623613383,Chris Marsh,2,2,0
597923939,David Lovegrove,788605510,Mark Rose,2,1,1
598117191,Jerome Fowler,951468676,Steve Burchett,2,1,1
598552542,John Colgan,674307680,Neil McCafferty,2,1,1
598552542,John Colgan,746406369,Loz O'Keefe,2,1,1
598552542,John Colgan,815023707,David Senior,2,2,0
598552542,John Colgan,820231590,Alan Rook,2,1,1
598552542,John Colgan,844676925,Kieran Williams,2,1,1
598552542,John Colgan,922772801,Nick Buonanno,2,0,2
598552542,John Colgan,929636592,Danny Wilson,2,1,1
598846718,Ben Sorrell,613893140,Matt Warner,2,0,2
598846718,Ben Sorrell,677110925,Jake Dunstall,2,2,0
598846718,Ben Sorrell,688252012,Sean Cooper,2,1,1
598846718,Ben Sorrell,713064363,John Trory,2,1,1
598846718,Ben Sorrell,836895047,Ian McKay,2,0,2
598846718,Ben Sorrell,867613624,Ian Dunhill,2,0,2
598846718,Ben Sorrell,873916947,Geoff Akehurst,2,1,1
598846718,Ben Sorrell,910809545,Blake Harman,2,1,1
598846718,Ben Sorrell,971308746,Clive Harman,2,1,1
600385553,Darren Welfare,617751649,Lee Simpson,2,0,2
600385553,Darren Welfare,666735933,Mike Collier,2,0,2
600385553,Darren Welfare,856755662,David Marsh,2,2,0
608140548,David Gillingham,733453947,Phil Canham,2,2,0
608140548,David Gillingham,748064029,Paul Hughes,2,2,0
608140548,David Gillingham,773216781,Sean Payne,2,2,0
608140548,David Gillingham,866506631,Mark Smith,2,1,1
608140548,David Gillingham,889234854,Paul Smith,2,2,0
608140548,David Gillingham,974385564,Danny Booker,2,1,1
612265840,Paul Honeysett,688252012,Sean Cooper,2,0,2
612265840,Paul Honeysett,704007508,Alan Muir,2,0,2
612265840,Paul Honeysett,733453947,Phil Canham,2,1,1
612265840,Paul Honeysett,835713833,Olly Stewart,2,0,2
612265840,Paul Honeysett,844676925,Kieran Williams,2,1,1
612265840,Paul Honeysett,867613624,Ian Dunhill,2,0,2
612265840,Paul Honeysett,910809545,Blake Harman,2,0,2
612265840,Paul Honeysett,966905561,Tony Dade,2,2,0
612265840,Paul Honeysett,970786910,Kevin Sorrell,2,0,2
612265840,Paul Honeysett,971308746,Clive Harman,2,0,2
612265840,Paul Honeysett,978156264,Bob Paine,2,1,1
613889718,Terry Bashford,623613383,Chris Marsh,2,0,2
613893140,Matt Warner,676753614,Don James,2,1,1
613893140,Matt Warner,688252012,Sean Cooper,2,2,0
613893140,Matt Warner,688778183,Dean Paice,2,1,1
613893140,Matt Warner,704007508,Alan Muir,2,2,0
613893140,Matt Warner,733453947,Phil Canham,2,1,1
613893140,Matt Warner,788605510,Mark Rose,2,0,2
613893140,Matt Warner,831214643,Tony Shipley,2,0,2
613893140,Matt Warner,836895047,Ian McKay,2,0,2
613893140,Matt Warner,948504778,Jon Fordham,2,0,2
613893140,Matt Warner,968651401,Ryan Grover,2,2,0
617252199,Jim Griffiths,728690686,Rick Rothschild,2,2,0
617751649,Lee Simpson,662568995,Rob Wykes,2,1,1
617751649,Lee Simpson,717256135,Trevor Pickard,2,2,0
617751649,Lee Simpson,732321233,Nathan Brooks,2,2,0
617751649,Lee Simpson,837429850,Paul Beecham,2,2,0
617751649,Lee Simpson,927588200,Tokki Yamaguchi,2,1,1
619390728,Steve Stylianou,646410961,Paul Scorer,2,0,2
619390728,Steve Stylianou,732321233,Nathan Brooks,2,1,1
619390728,Steve Stylianou,797962517,Dave Lewis,2,1,1
619390728,Steve Stylianou,927588200,Tokki Yamaguchi,2,1,1
619390728,Steve Stylianou,948504778,Jon Fordham,2,2,0
623613383,Chris Marsh,866506631,Mark Smith,2,1,1
623613383,Chris Marsh,899206834,Jez Downs,2,1,1
629014363,Lee Shepherd,809568302,Mark Johnson,2,1,1
629014363,Lee Shepherd,954080507,Sam Corsby,2,1,1
629014363,Lee Shepherd,963958265,Rodney Moogan,2,2,0
629014363,Lee Shepherd,974385564,Danny Booker,2,1,1
641692362,Bob Taylor,825399596,Pat Adams,2,1,1
641692362,Bob Taylor,845537273,Dave Gridley,2,0,2
641692362,Bob Taylor,947620111,Neil Cutler,2,1,1
646410961,Paul Scorer,703030938,Ollie Thurmer,2,2,0
646410961,Paul Scorer,825399596,Pat Adams,2,2,0
646410961,Paul Scorer,865803068,Dave Jones,2,1,1
646410961,Paul Scorer,927588200,Tokki Yamaguchi,2,0,2
646614924,Norman Moye,901024459,Paul Charman,2,1,1
649078882,Richard Barrett,836895047,Ian McKay,2,1,1
649240057,Mike Childs,688252012,Sean Cooper,2,0,2
649240057,Mike Childs,943667183,John Stone,2,1,1
649240057,Mike Childs,966905561,Tony Dade,2,0,2
649307517,Wes Kingham,836895047,Ian McKay,2,0,2
649307517,Wes Kingham,873916947,Geoff Akehurst,2,2,0
654650203,Alan O'Sullivan,688252012,Sean Cooper,2,1,1
654650203,Alan O'Sullivan,736672590,Dean Perry,2,1,1
654650203,Alan O'Sullivan,866506631,Mark Smith,2,1,1
655917217,Terry Mills,721321839,Matt Peake,2,0,2
655917217,Terry Mills,732415457,Barry Hall,2,1,1
655917217,Terry Mills,848997254,Tom Parker,2,0,2
657320021,Brett Strevens,688749133,Dan Hease,2,0,2
657320021,Brett Strevens,880982797,Ray Hunter,2,1,1
657320021,Brett Strevens,953512654,Les Berry,2,1,1
661923191,Steve Gardner,688778183,Dean Paice,2,0,2
661923191,Steve Gardner,717256135,Trevor Pickard,2,1,1
661923191,Steve Gardner,719124015,Tony Power,2,0,2
661923191,Steve Gardner,836895047,Ian McKay,2,1,1
661923191,Steve Gardner,880982797,Ray Hunter,2,1,1
662568995,Rob Wykes,670256222,Connor Anderson,2,2,0
662568995,Rob Wykes,752709358,Chris Mason,2,1,1
662568995,Rob Wykes,766684900,John Gillard,2,0,2
662568995,Rob Wykes,797962517,Dave Lewis,2,2,0
662568995,Rob Wykes,963958265,Rodney Moogan,2,1,1
666735933,Mike Collier,764177688,Barry Martin,2,2,0
666735933,Mike Collier,948504778,Jon Fordham,2,1,1
666735933,Mike Collier,963958265,Rodney Moogan,2,2,0
669385277,Steve Towler,688778183,Dean Paice,2,0,2
669385277,Steve Towler,703030938,Ollie Thurmer,2,2,0
669385277,Steve Towler,880982797,Ray Hunter,2,1,1
669385277,Steve Towler,889684922,Zixun Wang,2,0,2
669385277,Steve Towler,929636592,Danny Wilson,2,2,0
669385277,Steve Towler,949603489,Pete Bennett,2,0,2
669385277,Steve Towler,951468676,Steve Burchett,2,0,2
670034050,John Muzio,713064363,John Trory,2,2,0
670034050,John Muzio,732415457,Barry Hall,2,2,0
670034050,John Muzio,773216781,Sean Payne,2,0,2
670034050,John Muzio,805165161,Steve Owen,2,0,2
670034050,John Muzio,836895047,Ian McKay,2,2,0
670034050,John Muzio,866506631,Mark Smith,2,0,2
670034050,John Muzio,889684922,Zixun Wang,2,0,2
670034050,John Muzio,915035871,Kevin Graysmark,2,2,0
670034050,John Muzio,974385564,Danny Booker,2,0,2
670256222,Connor Anderson,717256135,Trevor Pickard,2,2,0
670256222,Connor Anderson,802242736,Steve Hughes,2,2,0
670256222,Connor Anderson,837429850,Paul Beecham,2,2,0
670256222,Connor Anderson,878576746,Jon Hall,2,2,0
670256222,Connor Anderson,947143243,Chris Davis,2,2,0
670870044,David Flanagan,724342701,Nigel Lilley,2,2,0
670870044,David Flanagan,737709582,Tony Browne,2,1,1
670870044,David Flanagan,867613624,Ian Dunhill,2,2,0
670870044,David Flanagan,899206834,Jez Downs,2,1,1
670870044,David Flanagan,929636592,Danny Wilson,2,2,0
676753614,Don James,873916947,Geoff Akehurst,2,2,0
676753614,Don James,884374645,Wayne Iddon,2,1,1
676753614,Don James,929636592,Danny Wilson,2,2,0
676753614,Don James,966905561,Tony Dade,2,0,2
677110925,Jake Dunstall,713064363,John Trory,2,2,0
677110925,Jake Dunstall,915035871,Kevin Graysmark,2,0,2
680442672,Scott Lawson,721321839,Matt Peake,2,0,2
680442672,Scott Lawson,752709358,Chris Mason,2,0,2
680442672,Scott Lawson,754250007,Freddie Blunden,2,0,2
680442672,Scott Lawson,800114325,Roger Whiteley,2,1,1
680442672,Scott Lawson,822983250,Alasdair Pratt,2,1,1
680442672,Scott Lawson,825399596,Pat Adams,2,1,1
680442672,Scott Lawson,878576746,Jon Hall,2,1,1
680442672,Scott Lawson,949603489,Pete Bennett,2,2,0
683709119,Ronnie Beard,797962517,Dave Lewis,2,0,2
683709119,Ronnie Beard,809568302,Mark Johnson,2,0,2
688252012,Sean Cooper,688778183,Dean Paice,2,0,2
688252012,Sean Cooper,728690686,Rick Rothschild,2,1,1
688252012,Sean Cooper,800114325,Roger Whiteley,2,0,2
688252012,Sean Cooper,820231590,Alan Rook,2,1,1
688252012,Sean Cooper,910809545,Blake Harman,2,1,1
688749133,Dan Hease,740135236,Craig Marchant,2,1,1
688778183,Dean Paice,717256135,Trevor Pickard,2,2,0
688778183,Dean Paice,724342701,Nigel Lilley,2,2,0
688778183,Dean Paice,835713833,Olly Stewart,2,1,1
688778183,Dean Paice,867613624,Ian Dunhill,2,1,1
688778183,Dean Paice,910809545,Blake Harman,2,1,1
688778183,Dean Paice,947620111,Neil Cutler,2,2,0
688778183,Dean Paice,953512654,Les Berry,2,2,0
688778183,Dean Paice,963206772,Dean Moore,2,0,2
703030938,Ollie Thurmer,745152759,Kevin Jewell,2,2,0
703030938,Ollie Thurmer,963206772,Dean Moore,2,0,2
704007508,Alan Muir,719124015,Tony Power,2,0,2
704007508,Alan Muir,800114325,Roger Whiteley,2,0,2
704007508,Alan Muir,820231590,Alan Rook,2,0,2
704007508,Alan Muir,836895047,Ian McKay,2,1,1
704007508,Alan Muir,880982797,Ray Hunter,2,2,0
704007508,Alan Muir,929636592,Danny Wilson,2,0,2
704007508,Alan Muir,962678119,John Worth,2,2,0
713064363,John Trory,805165161,Steve Owen,2,0,2
713064363,John Trory,833156731,Jez Saunders,2,0,2
713064363,John Trory,848997254,Tom Parker,2,0,2
713064363,John Trory,968651401,Ryan Grover,2,0,2
713064363,John Trory,971308746,Clive Harman,2,0,2
717256135,Trevor Pickard,721321839,Matt Peake,2,0,2
717256135,Trevor Pickard,797313851,Dave Anderson,2,2,0
717256135,Trevor Pickard,866506631,Mark Smith,2,1,1
717256135,Trevor Pickard,948504778,Jon Fordham,2,1,1
717256135,Trevor Pickard,954297832,Pav Sareen,2,0,2
719124015,Tony Power,732415457,Barry Hall,2,1,1
719124015,Tony Power,810143915,Ben Welfare,2,0,2
719124015,Tony Power,850059806,Heng Wong,2,0,2
719124015,Tony Power,878576746,Jon Hall,2,0,2
719124015,Tony Power,889684922,Zixun Wang,2,1,1
719124015,Tony Power,948504778,Jon Fordham,2,1,1
719124015,Tony Power,954080507,Sam Corsby,2,0,2
721321839,Matt Peake,736672590,Dean Perry,2,2,0
721321839,Matt Peake,773216781,Sean Payne,2,1,1
721321839,Matt Peake,836895047,Ian McKay,2,0,2
721321839,Matt Peake,848997254,Tom Parker,2,1,1
721321839,Matt Peake,970786910,Kevin Sorrell,2,1,1
721321839,Matt Peake,971308746,Clive Harman,2,2,0
724342701,Nigel Lilley,737709582,Tony Browne,2,2,0
724342701,Nigel Lilley,856755662,David Marsh,2,0,2
724342701,Nigel Lilley,867613624,Ian Dunhill,2,2,0
724342701,Nigel Lilley,936624299,Peter Gallant,2,2,0
724342701,Nigel Lilley,971308746,Clive Harman,2,0,2
726498878,Grigory Yashkov,974385564,Danny Booker,2,0,2
728690686,Rick Rothschild,732415457,Barry Hall,2,0,2
728690686,Rick Rothschild,736672590,Dean Perry,2,0,2
728690686,Rick Rothschild,949603489,Pete Bennett,2,0,2
732321233,Nathan Brooks,836895047,Ian McKay,2,1,1
732321233,Nathan Brooks,948504778,Jon Fordham,2,0,2
732415457,Barry Hall,858283721,Dave Dunstall,2,1,1
732415457,Barry Hall,873916947,Geoff Akehurst,2,2,0
732415457,Barry Hall,915035871,Kevin Graysmark,2,2,0
732415457,Barry Hall,968651401,Ryan Grover,2,2,0
732415457,Barry Hall,970786910,Kevin Sorrell,2,1,1
733453947,Phil Canham,788605510,Mark Rose,2,0,2
733453947,Phil Canham,820231590,Alan Rook,2,2,0
733453947,Phil Canham,901024459,Paul Charman,2,2,0
733453947,Phil Canham,936624299,Peter Gallant,2,2,0
733453947,Phil Canham,954080507,Sam Corsby,2,0,2
733453947,Phil Canham,954639632,Derek Budde,2,1,1
733453947,Phil Canham,962678119,John Worth,2,2,0
733453947,Phil Canham,963206772,Dean Moore,2,0,2
734416600,DON PENALVER,773216781,Sean Payne,2,0,2
736672590,Dean Perry,809984729,Neil Scutt,2,0,2
736672590,Dean Perry,873916947,Geoff Akehurst,2,2,0
736672590,Dean Perry,922772801,Nick Buonanno,2,1,1
737709582,Tony Browne,804381932,Ryan Harman,2,1,1
737709582,Tony Browne,889234854,Paul Smith,2,2,0
740135236,Craig Marchant,929636592,Danny Wilson,2,0,2
745152759,Kevin Jewell,873916947,Geoff Akehurst,2,2,0
745152759,Kevin Jewell,899206834,Jez Downs,2,0,2
745152759,Kevin Jewell,948504778,Jon Fordham,2,0,2
745152759,Kevin Jewell,951468676,Steve Burchett,2,0,2
746406369,Loz O'Keefe,809984729,Neil Scutt,2,1,1
746406369,Loz O'Keefe,929636592,Danny Wilson,2,1,1
746406369,Loz O'Keefe,968651401,Ryan Grover,2,2,0
746406369,Loz O'Keefe,978156264,Bob Paine,2,2,0
747966869,Richard Morgan,809647573,John Taylor,2,0,2
747966869,Richard Morgan,809984729,Neil Scutt,2,1,1
747966869,Richard Morgan,929636592,Danny Wilson,2,1,1
748064029,Paul Hughes,766684900,John Gillard,2,0,2
748064029,Paul Hughes,797962517,Dave Lewis,2,2,0
748064029,Paul Hughes,825399596,Pat Adams,2,2,0
748064029,Paul Hughes,837429850,Paul Beecham,2,2,0
748064029,Paul Hughes,927588200,Tokki Yamaguchi,2,0,2
752709358,Chris Mason,802242736,Steve Hughes,2,2,0
752709358,Chris Mason,809568302,Mark Johnson,2,1,1
752709358,Chris Mason,876526526,Ash Bull,2,2,0
752709358,Chris Mason,947143243,Chris Davis,2,2,0
752709358,Chris Mason,954080507,Sam Corsby,2,1,1
752709358,Chris Mason,963958265,Rodney Moogan,2,2,0
754250007,Freddie Blunden,764177688,Barry Martin,2,2,0
754250007,Freddie Blunden,809647573,John Taylor,2,2,0
754250007,Freddie Blunden,850059806,Heng Wong,2,2,0
754250007,Freddie Blunden,865803068,Dave Jones,2,0,2
754250007,Freddie Blunden,927588200,Tokki Yamaguchi,2,1,1
754250007,Freddie Blunden,931210057,Huntley Roberts,2,2,0
754250007,Freddie Blunden,948504778,Jon Fordham,2,2,0
757827662,Clive Freestone,800114325,Roger Whiteley,2,1,1
757827662,Clive Freestone,880982797,Ray Hunter,2,1,1
764177688,Barry Martin,766684900,John Gillard,2,0,2
764177688,Barry Martin,963958265,Rodney Moogan,2,2,0
766684900,John Gillard,794630189,Mark Coles,2,1,1
766684900,John Gillard,797962517,Dave Lewis,2,2,0
766684900,John Gillard,809568302,Mark Johnson,2,2,0
766684900,John Gillard,825399596,Pat Adams,2,0,2
766684900,John Gillard,927588200,Tokki Yamaguchi,2,2,0
773216781,Sean Payne,802242736,Steve Hughes,2,1,1
773216781,Sean Payne,848997254,Tom Parker,2,1,1
773216781,Sean Payne,867613624,Ian Dunhill,2,2,0
773216781,Sean Payne,889234854,Paul Smith,2,2,0
773216781,Sean Payne,954080507,Sam Corsby,2,2,0
788605510,Mark Rose,800114325,Roger Whiteley,2,2,0
797313851,Dave Anderson,878576746,Jon Hall,2,1,1
797313851,Dave Anderson,949603489,Pete Bennett,2,1,1
797962517,Dave Lewis,802242736,Steve Hughes,2,0,2
797962517,Dave Lewis,809788967,Brett Williams,2,1,1
797962517,Dave Lewis,825399596,Pat Adams,2,1,1
797962517,Dave Lewis,837429850,Paul Beecham,2,1,1
800114325,Roger Whiteley,873916947,Geoff Akehurst,2,2,0
802242736,Steve Hughes,865803068,Dave Jones,2,0,2
805165161,Steve Owen,809647573,John Taylor,2,2,0
805165161,Steve Owen,848997254,Tom Parker,2,1,1
805165161,Steve Owen,954080507,Sam Corsby,2,1,1
809568302,Mark Johnson,850059806,Heng Wong,2,2,0
809568302,Mark Johnson,947143243,Chris Davis,2,1,1
809647573,John Taylor,809984729,Neil Scutt,2,1,1
809788967,Brett Williams,948504778,Jon Fordham,2,0,2
809984729,Neil Scutt,833156731,Jez Saunders,2,2,0
809984729,Neil Scutt,845758589,Charlie James,2,2,0
809984729,Neil Scutt,884374645,Wayne Iddon,2,2,0
809984729,Neil Scutt,951468676,Steve Burchett,2,0,2
810143915,Ben Welfare,974385564,Danny Booker,2,1,1
815023707,David Senior,867613624,Ian Dunhill,2,0,2
820231590,Alan Rook,831214643,Tony Shipley,2,0,2
820231590,Alan Rook,844676925,Kieran Williams,2,0,2
820231590,Alan Rook,856755662,David Marsh,2,1,1
820231590,Alan Rook,884374645,Wayne Iddon,2,0,2
820231590,Alan Rook,953512654,Les Berry,2,2,0
820231590,Alan Rook,966905561,Tony Dade,2,1,1
820231590,Alan Rook,971308746,Clive Harman,2,0,2
822983250,Alasdair Pratt,836895047,Ian McKay,2,1,1
822983250,Alasdair Pratt,878576746,Jon Hall,2,2,0
822983250,Alasdair Pratt,884374645,Wayne Iddon,2,0,2
822983250,Alasdair Pratt,949603489,Pete Bennett,2,2,0
831214643,Tony Shipley,833156731,Jez Saunders,2,2,0
831214643,Tony Shipley,866506631,Mark Smith,2,1,1
831214643,Tony Shipley,978156264,Bob Paine,2,2,0
833156731,Jez Saunders,835713833,Olly Stewart,2,0,2
835713833,Olly Stewart,889234854,Paul Smith,2,2,0
835713833,Olly Stewart,963206772,Dean Moore,2,1,1
836895047,Ian McKay,848997254,Tom Parker,2,1,1
836895047,Ian McKay,880982797,Ray Hunter,2,2,0
836895047,Ian McKay,954080507,Sam Corsby,2,0,2
837429850,Paul Beecham,850059806,Heng Wong,2,0,2
837429850,Paul Beecham,899206834,Jez Downs,2,2,0
837429850,Paul Beecham,949603489,Pete Bennett,2,0,2
843981340,Mark Glover,845758589,Charlie James,2,2,0
844676925,Kieran Williams,943667183,John Stone,2,2,0
844676925,Kieran Williams,963206772,Dean Moore,2,1,1
845537273,Dave Gridley,974385564,Danny Booker,2,1,1
845758589,Charlie James,858283721,Dave Dunstall,2,2,0
845758589,Charlie James,867613624,Ian Dunhill,2,0,2
845758589,Charlie James,915035871,Kevin Graysmark,2,1,1
845758589,Charlie James,922772801,Nick Buonanno,2,0,2
845758589,Charlie James,929636592,Danny Wilson,2,1,1
845758589,Charlie James,951468676,Steve Burchett,2,0,2
845758589,Charlie James,978156264,Bob Paine,2,2,0
848997254,Tom Parker,899206834,Jez Downs,2,1,1
848997254,Tom Parker,949603489,Pete Bennett,2,0,2
850059806,Heng Wong,865803068,Dave Jones,2,1,1
852327692,Andy Fletcher,963206772,Dean Moore,2,0,2
858283721,Dave Dunstall,943667183,John Stone,2,0,2
858283721,Dave Dunstall,966905561,Tony Dade,2,2,0
858283721,Dave Dunstall,978156264,Bob Paine,2,2,0
865803068,Dave Jones,963958265,Rodney Moogan,2,2,0
866506631,Mark Smith,878576746,Jon Hall,2,1,1
866506631,Mark Smith,880982797,Ray Hunter,2,1,1
866506631,Mark Smith,949603489,Pete Bennett,2,0,2
866506631,Mark Smith,954080507,Sam Corsby,2,0,2
866506631,Mark Smith,971308746,Clive Harman,2,2,0
867613624,Ian Dunhill,966905561,Tony Dade,2,1,1
867613624,Ian Dunhill,970786910,Kevin Sorrell,2,0,2
867613624,Ian Dunhill,971308746,Clive Harman,2,0,2
876526526,Ash Bull,884365412,Dave Haslam,2,2,0
876526526,Ash Bull,957784480,Harry Banks,2,2,0
878576746,Jon Hall,889234854,Paul Smith,2,1,1
880982797,Ray Hunter,957784480,Harry Banks,2,0,2
884374645,Wayne Iddon,948504778,Jon Fordham,2,1,1
884374645,Wayne Iddon,951468676,Steve Burchett,2,1,1
889234854,Paul Smith,915035871,Kevin Graysmark,2,1,1
889234854,Paul Smith,971308746,Clive Harman,2,1,1
889234854,Paul Smith,974385564,Danny Booker,2,0,2
899206834,Jez Downs,951468676,Steve Burchett,2,1,1
899206834,Jez Downs,971308746,Clive Harman,2,0,2
899206834,Jez Downs,980908578,Jake Whatman,2,1,1
910809545,Blake Harman,943667183,John Stone,2,0,2
915035871,Kevin Graysmark,970786910,Kevin Sorrell,2,0,2
927588200,Tokki Yamaguchi,957784480,Harry Banks,2,1,1
931210057,Huntley Roberts,957784480,Harry Banks,2,1,1
936624299,Peter Gallant,951468676,Steve Burchett,2,0,2
936624299,Peter Gallant,978156264,Bob Paine,2,2,0
943667183,John Stone,953512654,Les Berry,2,0,2
947143243,Chris Davis,957784480,Harry Banks,2,2,0
948504778,Jon Fordham,957784480,Harry Banks,2,1,1
948504778,Jon Fordham,963206772,Dean Moore,2,2,0
949603489,Pete Bennett,974385564,Danny Booker,2,0,2
951468676,Steve Burchett,968651401,Ryan Grover,2,1,1
954297832,Pav Sareen,963958265,Rodney Moogan,2,0,2
954297832,Pav Sareen,970786910,Kevin Sorrell,2,2,0
963206772,Dean Moore,971308746,Clive Harman,2,2,0
963206772,Dean Moore,974385564,Danny Booker,2,0,2
